//MAP CONVERTED BY dmm2tgm.py THIS HEADER COMMENT PREVENTS RECONVERSION, DO NOT REMOVE
"a" = (
/turf/open/floor/cobble,
/area/rogue/under/cave)
"b" = (
/obj/machinery/light/fueled/torchholder/c,
/obj/effect/decal/cleanable/generic,
/turf/open/floor/ruinedwood/darker,
/area/rogue/under/cave)
"c" = (
/turf/closed/wall/mineral/stone/moss,
/area/rogue/under/cave)
"d" = (
/turf/closed/wall/mineral/stone,
/area/rogue/under/cave)
"e" = (
/obj/machinery/light/fueled/torchholder/l,
/turf/open/floor/cobble,
/area/rogue/under/cave)
"f" = (
/obj/machinery/light/fueled/campfire/densefire,
/turf/open/floor/cobble,
/area/rogue/under/cave)
"g" = (
/obj/effect/decal/cleanable/dirt,
/turf/open/floor/cobble,
/area/rogue/under/cave)
"h" = (
/obj/structure/roguetent,
/obj/effect/decal/cleanable/dirt/cobweb,
/turf/open/floor/cobble,
/area/rogue/under/cave)
"i" = (
/obj/machinery/light/fueled/torchholder/r,
/turf/open/floor/ruinedwood/darker,
/area/rogue/under/cave)
"k" = (
/turf/closed/mineral/bedrock,
/area/rogue/under/cave)
"l" = (
/obj/effect/decal/cleanable/dirt,
/turf/open/floor/ruinedwood/darker,
/area/rogue/under/cave)
"m" = (
/obj/effect/dungeon_directional_helper/south,
/turf/open/floor/cobble,
/area/rogue/under/cave)
"n" = (
/obj/effect/decal/cleanable/dirt,
/obj/effect/decal/remains/bigrat,
/turf/open/floor/cobble,
/area/rogue/under/cave)
"o" = (
/obj/effect/decal/cleanable/blood/old,
/obj/machinery/light/fueled/torchholder/l,
/turf/open/floor/cobble,
/area/rogue/under/cave)
"p" = (
/obj/machinery/light/fueled/torchholder/l,
/turf/open/floor/ruinedwood/darker,
/area/rogue/under/cave)
"q" = (
/obj/effect/decal/cleanable/generic,
/turf/open/floor/ruinedwood/darker,
/area/rogue/under/cave)
"r" = (
/obj/structure/mineral_door/wood,
/turf/open/floor/ruinedwood/darker,
/area/rogue/under/cave)
"s" = (
/obj/structure/fluff/walldeco/skullspike,
/turf/open/floor/cobble,
/area/rogue/under/cave)
"t" = (
/obj/effect/decal/remains/human,
/obj/effect/decal/cleanable/blood/old,
/turf/open/floor/metal,
/area/rogue/under/cave)
"u" = (
/obj/structure/roguetent,
/turf/open/floor/cobble,
/area/rogue/under/cave)
"v" = (
/mob/living/simple_animal/hostile/retaliate/troll,
/obj/effect/decal/cleanable/blood,
/turf/open/floor/metal,
/area/rogue/under/cave)
"w" = (
/mob/living/carbon/human/species/goblin/npc/cave,
/turf/open/floor/cobble,
/area/rogue/under/cave)
"x" = (
/obj/effect/decal/cleanable/blood,
/turf/open/floor/cobble,
/area/rogue/under/cave)
"y" = (
/obj/effect/decal/remains/bigrat,
/turf/open/floor/cobble,
/area/rogue/under/cave)
"z" = (
/turf/open/floor/ruinedwood/darker,
/area/rogue/under/cave)
"A" = (
/obj/structure/closet/crate/chest/old_crate,
/obj/item/reagent_containers/glass/bottle/healthpot,
/obj/item/reagent_containers/food/snacks/meat/sausage,
/obj/item/reagent_containers/food/snacks/meat/sausage,
/obj/item/reagent_containers/food/snacks/meat/sausage,
/obj/effect/decal/cleanable/dirt/cobweb/cobweb2,
/turf/open/floor/cobble,
/area/rogue/under/cave)
"B" = (
/obj/structure/bars,
/turf/open/floor/metal,
/area/rogue/under/cave)
"C" = (
/obj/item/skull,
/obj/item/skull,
/obj/item/skull{
	pixel_y = 2;
	pixel_x = 8
	},
/obj/item/skull{
	pixel_x = 4;
	pixel_y = -3
	},
/obj/item/skull{
	pixel_x = 5;
	pixel_y = 5
	},
/obj/item/skull{
	pixel_y = 10
	},
/turf/open/floor/cobble,
/area/rogue/under/cave)
"D" = (
/obj/effect/decal/cleanable/blood/old,
/turf/open/floor/metal,
/area/rogue/under/cave)
"E" = (
/obj/effect/dungeon_directional_helper/west,
/turf/open/floor/cobble,
/area/rogue/under/cave)
"F" = (
/obj/effect/decal/cleanable/blood/old,
/turf/open/floor/cobble,
/area/rogue/under/cave)
"H" = (
/obj/machinery/light/fueled/torchholder/c,
/turf/open/floor/ruinedwood/darker,
/area/rogue/under/cave)
"I" = (
/obj/machinery/light/fueled/torchholder{
	pixel_y = -32
	},
/turf/open/floor/ruinedwood/darker,
/area/rogue/under/cave)
"J" = (
/obj/machinery/light/fueled/torchholder/l,
/obj/effect/decal/cleanable/generic,
/turf/open/floor/ruinedwood/darker,
/area/rogue/under/cave)
"K" = (
/turf/open/floor/metal,
/area/rogue/under/cave)
"L" = (
/obj/effect/decal/cleanable/blood/tracks{
	dir = 6
	},
/turf/open/floor/cobble,
/area/rogue/under/cave)
"M" = (
/obj/effect/decal/cleanable/blood/old,
/obj/effect/decal/remains/bigrat,
/turf/open/floor/metal,
/area/rogue/under/cave)
"N" = (
/obj/effect/decal/cleanable/blood/tracks{
	dir = 4
	},
/turf/open/floor/cobble,
/area/rogue/under/cave)
"P" = (
/obj/machinery/light/fueled/torchholder/r,
/turf/open/floor/cobble,
/area/rogue/under/cave)
"Q" = (
/obj/effect/decal/remains/human,
/turf/open/floor/cobble,
/area/rogue/under/cave)
"R" = (
/obj/effect/dungeon_directional_helper/north,
/turf/open/floor/cobble,
/area/rogue/under/cave)
"S" = (
/obj/effect/decal/cleanable/blood,
/turf/open/floor/metal,
/area/rogue/under/cave)
"T" = (
/obj/effect/decal/remains/human,
/turf/open/floor/metal,
/area/rogue/under/cave)
"U" = (
/mob/living/carbon/human/species/goblin/npc/cave,
/obj/effect/decal/cleanable/dirt,
/turf/open/floor/cobble,
/area/rogue/under/cave)
"W" = (
/obj/effect/dungeon_directional_helper/east,
/turf/open/floor/cobble,
/area/rogue/under/cave)
"X" = (
/obj/effect/decal/cleanable/blood/splatter,
/turf/open/floor/cobble,
/area/rogue/under/cave)
"Y" = (
/obj/structure/mineral_door/bars,
/turf/open/floor/metal,
/area/rogue/under/cave)

(1,1,1) = {"
k
k
k
k
k
E
a
k
k
k
k
k
"}
(2,1,1) = {"
k
c
c
d
d
a
a
d
c
d
c
k
"}
(3,1,1) = {"
k
c
h
e
u
F
a
s
o
y
d
k
"}
(4,1,1) = {"
k
d
Q
F
a
a
a
a
e
g
d
k
"}
(5,1,1) = {"
k
d
u
a
u
a
a
a
a
n
c
k
"}
(6,1,1) = {"
R
a
g
a
a
a
x
x
F
a
a
m
"}
(7,1,1) = {"
a
a
g
a
a
F
X
X
a
a
a
a
"}
(8,1,1) = {"
k
c
w
a
w
g
N
F
Q
a
d
k
"}
(9,1,1) = {"
k
c
a
f
w
a
N
s
C
a
c
k
"}
(10,1,1) = {"
k
c
A
g
U
a
L
a
P
g
c
k
"}
(11,1,1) = {"
k
d
d
d
d
a
a
c
c
c
d
k
"}
(12,1,1) = {"
k
k
k
k
k
W
a
k
k
k
k
k
"}

(1,1,2) = {"
k
k
k
k
k
r
r
k
k
k
k
k
"}
(2,1,2) = {"
k
z
z
z
p
z
z
J
z
l
l
k
"}
(3,1,2) = {"
k
l
l
z
z
z
z
q
z
z
z
k
"}
(4,1,2) = {"
k
z
l
B
B
B
B
B
B
z
z
k
"}
(5,1,2) = {"
k
H
z
B
K
v
K
K
B
z
I
k
"}
(6,1,2) = {"
r
z
z
Y
K
t
K
D
Y
z
z
r
"}
(7,1,2) = {"
r
z
z
Y
K
K
S
T
Y
z
z
r
"}
(8,1,2) = {"
k
b
z
B
D
M
D
K
B
q
I
k
"}
(9,1,2) = {"
k
z
z
B
B
B
B
B
B
l
z
k
"}
(10,1,2) = {"
k
z
z
q
z
z
z
z
l
l
z
k
"}
(11,1,2) = {"
k
z
q
q
i
z
z
i
z
l
z
k
"}
(12,1,2) = {"
k
k
k
k
k
r
r
k
k
k
k
k
"}
