//MAP CONVERTED BY dmm2tgm.py THIS HEADER COMMENT PREVENTS RECONVERSION, DO NOT REMOVE
"au" = (
/turf/closed/wall/mineral/decostone/cand,
/area/rogue)
"aE" = (
/obj/structure/trap/poison,
/turf/open/floor/cobble,
/area/rogue)
"aK" = (
/turf/open/water/swamp,
/area/rogue)
"bm" = (
/mob/living/carbon/human/species/skeleton/npc/warrior/skilled,
/turf/open/floor/cobble/alt,
/area/rogue)
"bG" = (
/obj/structure/fluff/railing/wood,
/turf/open/floor/cobblerock,
/area/rogue)
"bW" = (
/obj/effect/decal/remains/human,
/obj/structure/bars,
/turf/open/floor/cobble,
/area/rogue)
"cn" = (
/obj/structure/trap/chill,
/turf/open/floor/cobble,
/area/rogue)
"co" = (
/obj/structure/closet/crate/chest/old_crate,
/obj/effect/spawner/map_spawner/loot/magic,
/turf/open/floor/cobble,
/area/rogue)
"cz" = (
/obj/structure/fluff/walldeco/chains,
/mob/living/carbon/human/species/skeleton/npc/ambush,
/turf/open/floor/cobble,
/area/rogue)
"dc" = (
/obj/structure/mineral_door/wood/violet,
/turf/open/floor/cobble,
/area/rogue)
"dw" = (
/obj/effect/spawner/map_spawner/loot/rare,
/turf/open/floor/cobble,
/area/rogue)
"dH" = (
/obj/structure/spider/stickyweb,
/obj/effect/decal/cleanable/blood/gibs,
/turf/open/floor/cobble,
/area/rogue)
"eD" = (
/obj/effect/spawner/map_spawner/treeorstump,
/obj/structure/flora/grass,
/turf/open/floor/grass,
/area/rogue)
"eT" = (
/obj/machinery/light/fueled/firebowl,
/obj/structure/trap/fire,
/turf/open/floor/blocks/stonered/tiny,
/area/rogue)
"eV" = (
/obj/structure/bars/cemetery,
/turf/open/floor/grass,
/area/rogue)
"gP" = (
/obj/effect/dungeon_directional_helper/east,
/turf/open/floor/cobble/alt,
/area/rogue)
"gV" = (
/obj/structure/fluff/statue/knight,
/turf/open/floor/blocks/stonered/tiny,
/area/rogue)
"hd" = (
/turf/open/floor/cobblerock,
/area/rogue)
"hm" = (
/obj/effect/decal/remains/cabbit,
/obj/structure/flora/grass/water/reeds,
/turf/open/water/swamp,
/area/rogue)
"hN" = (
/obj/structure/closet/crate/chest/lootbox,
/obj/effect/spawner/map_spawner/loot/medium,
/turf/open/floor/cobble,
/area/rogue)
"hU" = (
/obj/effect/decal/remains/cabbit,
/turf/open/floor/cobble,
/area/rogue)
"ia" = (
/obj/effect/decal/cleanable/blood/gibs/core,
/turf/open/floor/cobble/alt,
/area/rogue)
"ie" = (
/mob/living/simple_animal/hostile/retaliate/minotaur/axe,
/turf/open/floor/cobble,
/area/rogue)
"im" = (
/obj/structure/flora/grass,
/obj/item/restraints/legcuffs/beartrap/armed/camouflage,
/turf/open/floor/grass,
/area/rogue)
"iR" = (
/obj/structure/closet/dirthole/closed,
/obj/structure/gravemarker,
/turf/open/floor/grass,
/area/rogue)
"iT" = (
/mob/living/simple_animal/hostile/retaliate/spider,
/turf/open/floor/cobble,
/area/rogue)
"iZ" = (
/obj/structure/trap/poison,
/obj/effect/spawner/map_spawner/loot/common,
/turf/open/floor/cobble,
/area/rogue)
"jd" = (
/obj/structure/fluff/walldeco/stone,
/turf/closed/wall/mineral/stone,
/area/rogue)
"ju" = (
/mob/living/carbon/human/species/skeleton/npc/warrior/skilled,
/turf/open/floor/cobble,
/area/rogue)
"jx" = (
/obj/effect/decal/remains/human,
/turf/open/floor/cobble/alt,
/area/rogue)
"kd" = (
/obj/structure/closet/crate/chest/neu_fancy,
/obj/effect/spawner/map_spawner/loot/medium,
/turf/open/floor/cobble,
/area/rogue)
"kk" = (
/obj/structure/fluff/statue/knight/r,
/turf/open/floor/blocks/stonered/tiny,
/area/rogue)
"lp" = (
/obj/effect/decal/remains/human{
	pixel_y = 5
	},
/turf/open/floor/cobble/alt,
/area/rogue)
"lz" = (
/obj/structure/stairs/stone{
	dir = 4
	},
/turf/open/floor/cobble,
/area/rogue)
"lA" = (
/turf/open/floor/grass,
/area/rogue)
"lD" = (
/obj/effect/decal/remains/bigrat,
/turf/open/floor/cobble/alt,
/area/rogue)
"lF" = (
/obj/structure/bars,
/turf/open/floor/cobble,
/area/rogue)
"lL" = (
/obj/structure/fluff/railing/wood,
/obj/structure/fluff/railing/wood{
	dir = 4;
	pixel_x = 1
	},
/turf/open/floor/cobblerock,
/area/rogue)
"ms" = (
/obj/structure/spider/stickyweb,
/turf/open/floor/cobble,
/area/rogue)
"mR" = (
/obj/structure/closet/dirthole/closed,
/obj/structure/gravemarker,
/obj/structure/flora/grass,
/turf/open/floor/grass,
/area/rogue)
"mW" = (
/obj/effect/decal/cleanable/blood/footprints,
/turf/open/floor/cobble,
/area/rogue)
"nd" = (
/turf/closed/wall/mineral/stone,
/area/rogue)
"nt" = (
/mob/living/simple_animal/hostile/retaliate/spider,
/obj/effect/spawner/map_spawner/loot/common,
/turf/open/floor/cobble,
/area/rogue)
"nH" = (
/obj/structure/spider/stickyweb,
/obj/effect/decal/cleanable/blood/footprints,
/turf/open/floor/cobble/alt,
/area/rogue)
"oN" = (
/obj/structure/table/wood/counter/end,
/obj/item/book/granter/spell/magick/greaterfireball{
	pixel_y = 11;
	pixel_x = 15
	},
/turf/open/floor/blocks/stonered,
/area/rogue)
"oQ" = (
/obj/effect/decal/cleanable/blood/gibs/up,
/turf/open/floor/cobble/alt,
/area/rogue)
"pl" = (
/obj/effect/decal/remains/human,
/turf/open/floor/cobble,
/area/rogue)
"pJ" = (
/obj/effect/spawner/map_spawner/loot/common,
/turf/open/floor/cobble,
/area/rogue)
"pP" = (
/obj/structure/trap/fire,
/turf/open/floor/blocks/stonered/tiny,
/area/rogue)
"rc" = (
/obj/item/restraints/legcuffs/beartrap/armed/camouflage,
/turf/open/floor/cobblerock,
/area/rogue)
"rl" = (
/obj/structure/flora/grass/bush,
/obj/structure/flora/grass,
/turf/open/floor/grass,
/area/rogue)
"rM" = (
/obj/structure/spider/stickyweb,
/obj/structure/closet/crate/chest/neu_fancy,
/obj/effect/spawner/map_spawner/loot/weapon,
/turf/open/floor/cobble,
/area/rogue)
"si" = (
/obj/item/restraints/legcuffs/beartrap/armed/camouflage,
/turf/open/floor/grass,
/area/rogue)
"tA" = (
/obj/item/restraints/legcuffs/beartrap/armed/camouflage,
/turf/open/floor/dirt/road,
/area/rogue)
"uB" = (
/turf/open/floor/dirt/road,
/area/rogue)
"uV" = (
/obj/structure/spider/stickyweb,
/obj/structure/spider/stickyweb,
/turf/open/floor/cobble/alt,
/area/rogue)
"wj" = (
/obj/effect/decal/remains/bogbug,
/obj/structure/flora/grass/water/reeds,
/turf/open/water/swamp,
/area/rogue)
"wl" = (
/obj/structure/flora/grass/water/reeds,
/turf/open/water/swamp,
/area/rogue)
"wF" = (
/turf/open/floor/cobble,
/area/rogue)
"wH" = (
/obj/structure/mineral_door/wood/deadbolt,
/turf/open/floor/cobble,
/area/rogue)
"wJ" = (
/obj/effect/decal/remains/bogbug,
/turf/open/floor/cobble,
/area/rogue)
"ya" = (
/obj/structure/bars,
/obj/structure/bars,
/turf/open/floor/cobble,
/area/rogue)
"yk" = (
/obj/effect/decal/remains/human{
	pixel_x = 12
	},
/turf/open/floor/cobble/alt,
/area/rogue)
"yo" = (
/obj/structure/flora/grass,
/turf/open/floor/grass,
/area/rogue)
"yI" = (
/obj/machinery/light/fueled/firebowl/standing/blue,
/turf/open/floor/cobblerock,
/area/rogue)
"yK" = (
/obj/effect/decal/remains/human,
/obj/effect/spawner/map_spawner/loot/rare,
/turf/open/floor/cobble,
/area/rogue)
"zm" = (
/obj/effect/decal/cleanable/blood/footprints,
/turf/open/floor/cobble/alt,
/area/rogue)
"zu" = (
/turf/open/floor/blocks,
/area/rogue)
"AT" = (
/obj/effect/spawner/map_spawner/loot/potion_stats,
/turf/open/floor/cobble,
/area/rogue)
"Bt" = (
/obj/item/ash{
	pixel_x = -10
	},
/obj/item/ash{
	pixel_y = 6;
	pixel_x = 6
	},
/obj/item/ash{
	pixel_y = 6;
	pixel_x = 6
	},
/turf/open/floor/cobble,
/area/rogue)
"CA" = (
/obj/structure/stairs/stone{
	dir = 4
	},
/turf/open/floor/blocks,
/area/rogue)
"CL" = (
/obj/structure/flora/grass/water,
/obj/item/restraints/legcuffs/beartrap/armed/camouflage,
/turf/open/floor/dirt,
/area/rogue)
"CN" = (
/mob/living/simple_animal/hostile/retaliate/spider,
/turf/open/floor/cobble/alt,
/area/rogue)
"CO" = (
/mob/living/carbon/human/species/skeleton/npc/ambush,
/turf/open/floor/cobble,
/area/rogue)
"Ed" = (
/obj/structure/flora/grass,
/turf/closed/mineral/bedrock,
/area/rogue)
"Ei" = (
/obj/machinery/light/fueled/firebowl/standing/blue,
/turf/open/floor/blocks,
/area/rogue)
"Fg" = (
/obj/structure/closet/crate/chest/lootbox,
/obj/effect/spawner/map_spawner/loot/rare,
/turf/open/floor/cobble,
/area/rogue)
"FC" = (
/obj/machinery/light/fueled/firebowl,
/turf/open/floor/blocks/stonered/tiny,
/area/rogue)
"FO" = (
/turf/open/floor/cobble/alt,
/area/rogue)
"Ge" = (
/obj/effect/dungeon_directional_helper/south,
/turf/open/floor/cobble,
/area/rogue)
"Gn" = (
/obj/structure/table/wood/counter/end{
	dir = 1
	},
/turf/open/floor/blocks/stonered,
/area/rogue)
"GC" = (
/obj/structure/flora/grass/bush,
/turf/open/floor/grass,
/area/rogue)
"GY" = (
/obj/structure/flora/grass,
/turf/open/floor/dirt,
/area/rogue)
"Hd" = (
/obj/item/restraints/legcuffs/beartrap/armed/camouflage,
/turf/open/floor/dirt,
/area/rogue)
"Iy" = (
/obj/effect/decal/remains/human,
/obj/structure/flora/grass/water/reeds,
/turf/open/water/swamp,
/area/rogue)
"IJ" = (
/obj/effect/decal/remains/bogbug,
/turf/open/water/swamp,
/area/rogue)
"IQ" = (
/obj/effect/dungeon_directional_helper/west,
/turf/open/floor/cobble/alt,
/area/rogue)
"Jd" = (
/obj/effect/spawner/map_spawner/treeorstump,
/obj/item/restraints/legcuffs/beartrap/armed/camouflage,
/turf/open/floor/grass,
/area/rogue)
"Jf" = (
/obj/effect/decal/remains/human{
	pixel_y = 5
	},
/turf/open/floor/cobble,
/area/rogue)
"Jo" = (
/obj/effect/spawner/map_spawner/loot/potion_stats,
/turf/open/floor/cobble/alt,
/area/rogue)
"JZ" = (
/obj/structure/trap/fire,
/turf/open/floor/blocks/stonered,
/area/rogue)
"Kn" = (
/obj/structure/fluff/walldeco/chains,
/turf/closed/wall/mineral/stone,
/area/rogue)
"Kr" = (
/obj/effect/decal/remains/human,
/turf/open/water/swamp,
/area/rogue)
"KI" = (
/obj/structure/closet/dirthole/closed/loot,
/obj/structure/gravemarker,
/turf/open/floor/grass,
/area/rogue)
"La" = (
/obj/effect/spawner/map_spawner/treeorstump,
/turf/open/floor/grass,
/area/rogue)
"Ln" = (
/mob/living/carbon/human/species/skeleton/npc/ambush,
/turf/open/floor/cobble/alt,
/area/rogue)
"LB" = (
/obj/effect/spawner/map_spawner/treeorstump,
/turf/open/floor/dirt,
/area/rogue)
"LM" = (
/obj/structure/trap/shock,
/turf/open/floor/cobble,
/area/rogue)
"LR" = (
/turf/closed/mineral/bedrock,
/area/rogue)
"Mo" = (
/turf/open/floor/blocks/stonered,
/area/rogue)
"MB" = (
/obj/structure/spider/stickyweb,
/obj/structure/spider/stickyweb,
/turf/open/floor/cobble,
/area/rogue)
"ML" = (
/obj/effect/decal/remains/bigrat,
/obj/structure/flora/grass/water/reeds,
/turf/open/water/swamp,
/area/rogue)
"NM" = (
/turf/closed/wall/mineral/stone/moss,
/area/rogue)
"OH" = (
/turf/open/floor/blocks/stonered/tiny,
/area/rogue)
"Pu" = (
/obj/structure/flora/grass/water,
/turf/open/floor/dirt,
/area/rogue)
"PZ" = (
/obj/item/restraints/legcuffs/beartrap/armed/camouflage,
/turf/open/floor/blocks,
/area/rogue)
"Qe" = (
/obj/structure/trap/poison,
/turf/open/floor/cobble/alt,
/area/rogue)
"Qm" = (
/turf/open/transparent/openspace,
/area/rogue)
"Rn" = (
/obj/structure/mineral_door/bars,
/turf/open/floor/grass,
/area/rogue)
"RF" = (
/obj/structure/fluff/statue/astrata,
/obj/structure/trap/fire,
/turf/open/floor/blocks/stonered,
/area/rogue)
"Tt" = (
/obj/item/ash{
	pixel_y = -6
	},
/obj/item/ash{
	pixel_y = 6
	},
/obj/item/ash{
	pixel_x = -10
	},
/turf/open/floor/cobble,
/area/rogue)
"UD" = (
/obj/effect/dungeon_directional_helper/north,
/turf/open/floor/cobble,
/area/rogue)
"UF" = (
/obj/structure/trap/poison,
/turf/open/floor/cobblerock,
/area/rogue)
"UW" = (
/obj/structure/mineral_door/wood/donjon/stone,
/turf/open/floor/cobble,
/area/rogue)
"Vk" = (
/obj/item/clothing/ring/gold/rontz,
/turf/open/floor/cobblerock,
/area/rogue)
"Vr" = (
/obj/structure/fluff/railing/wood{
	dir = 4;
	pixel_x = 1
	},
/turf/open/floor/cobblerock,
/area/rogue)
"WC" = (
/obj/structure/fluff/walldeco/chains,
/turf/open/floor/cobble,
/area/rogue)
"WG" = (
/turf/open/floor/dirt,
/area/rogue)
"Xp" = (
/obj/structure/fluff/walldeco/chains,
/obj/structure/closet/crate/chest/neu_fancy,
/obj/effect/spawner/map_spawner/loot/armor,
/turf/open/floor/cobble,
/area/rogue)
"Ya" = (
/obj/structure/spider/stickyweb,
/turf/open/floor/cobble/alt,
/area/rogue)
"Zr" = (
/obj/effect/decal/cleanable/blood/gibs/torso,
/turf/open/floor/cobble,
/area/rogue)
"ZB" = (
/mob/living/carbon/human/species/skeleton/npc/no_equipment,
/turf/open/floor/cobble,
/area/rogue)

(1,1,1) = {"
nd
nd
nd
nd
nd
nd
nd
nd
nd
nd
nd
nd
nd
nd
ms
IQ
wF
nd
nd
nd
nd
nd
nd
nd
nd
nd
nd
nd
nd
nd
"}
(2,1,1) = {"
nd
ms
iT
oQ
Ya
dH
zm
ms
Zr
wF
wF
ms
wF
dc
ms
Ya
FO
FO
FO
aE
wF
wF
ms
wF
WC
aE
nd
wF
wF
nd
"}
(3,1,1) = {"
nd
aE
FO
ms
iT
wF
ia
Qe
nH
mW
wF
iT
wF
dc
wF
wF
WC
ms
Ya
yk
Ya
wF
wF
wF
FO
wF
dc
CO
wF
nd
"}
(4,1,1) = {"
nd
Fg
hN
nd
lF
lF
lF
nd
nd
nd
nd
wF
wF
nd
nd
nd
nd
nd
lF
lF
lF
nd
nd
nd
Ya
wF
nd
wF
aE
nd
"}
(5,1,1) = {"
nd
nd
nd
nd
ms
wF
nt
ms
FO
FO
ms
wF
ms
lF
Xp
Jf
CO
nd
wF
wF
wF
iT
wF
lF
FO
iT
nd
ms
cz
nd
"}
(6,1,1) = {"
nd
ms
wF
nd
lp
Ya
Ya
FO
Ya
FO
Ya
FO
wF
lF
kd
wF
wF
dc
pJ
wF
ms
ms
ms
lF
wF
ms
nd
ms
uV
nd
"}
(7,1,1) = {"
nd
ms
CO
dc
wF
iT
Jo
ms
MB
ms
iT
ms
wF
lF
CO
wF
wF
nd
ms
ms
wF
wF
pJ
nd
FO
ms
nd
Ya
wF
nd
"}
(8,1,1) = {"
nd
wF
wF
nd
nd
nd
nd
nd
nd
nd
nd
nd
nd
nd
wF
WC
wF
nd
iT
wF
wF
ms
wF
dc
FO
wF
dc
Ln
ms
nd
"}
(9,1,1) = {"
nd
wF
ms
jd
WC
CO
wF
wF
wF
ms
wF
LM
wF
dc
wF
wF
Jf
nd
lF
lF
nd
nd
nd
nd
jx
wF
nd
Ya
Ya
nd
"}
(10,1,1) = {"
nd
ZB
ms
lF
ms
wF
wF
ms
CO
wF
ms
wF
ms
nd
wF
wF
ZB
nd
wl
wl
lF
iZ
ZB
nd
Qe
FO
nd
hN
hN
nd
"}
(11,1,1) = {"
nd
WC
wF
lF
wF
aE
wF
nd
lF
lF
lF
lF
nd
nd
lF
lF
lF
bW
Iy
wl
lF
wF
ms
lF
wF
FO
nd
nd
nd
nd
"}
(12,1,1) = {"
nd
ms
wF
lF
wF
ms
wF
lF
wl
wl
wl
Iy
wl
wl
hm
wl
wl
wl
wl
wl
lF
wF
wF
nd
wF
ms
wF
ms
ms
nd
"}
(13,1,1) = {"
nd
wF
aE
jd
dw
ms
wF
lF
wl
aK
Kr
wF
hU
aK
aK
FO
wF
aK
aK
wl
lF
ms
wF
lF
ms
wF
FO
FO
wF
nd
"}
(14,1,1) = {"
wF
ms
ms
lF
ms
ms
wF
lF
wl
aK
wF
wF
wJ
wF
wF
FO
jx
wF
aK
Iy
nd
ms
wF
nd
lF
nd
ms
wF
FO
wF
"}
(15,1,1) = {"
UD
ms
wF
lF
FO
wF
ms
lF
ML
aK
wF
wF
wF
ie
dw
pl
FO
wF
wF
wl
nd
ZB
wF
wF
aE
nd
ms
pl
FO
Ge
"}
(16,1,1) = {"
wF
wF
ms
lF
Ln
FO
wF
nd
wl
aK
wF
wF
wF
wF
co
wF
wF
FO
aK
wl
lF
wF
pl
nd
wF
dc
wF
wF
FO
FO
"}
(17,1,1) = {"
nd
ms
wF
nd
aE
Ya
ms
nd
wl
IJ
wF
hU
wF
yK
wF
wF
wF
wF
Kr
wl
lF
wF
wF
nd
wF
nd
wF
ms
wF
nd
"}
(18,1,1) = {"
nd
nd
nd
nd
nd
wF
ms
ya
wl
aK
wF
wF
wF
FO
wF
ie
wF
wF
Kr
wl
lF
cn
FO
wF
wF
nd
wF
wF
ms
nd
"}
(19,1,1) = {"
nd
rM
wF
iT
dc
WC
wF
lF
wl
aK
wF
wF
lD
FO
hU
wF
FO
jx
aK
wl
lF
wF
wF
nd
CO
nd
WC
wF
wF
nd
"}
(20,1,1) = {"
nd
wF
ms
iT
nd
wF
wF
lF
wl
Kr
aK
FO
FO
wF
wF
FO
FO
FO
wF
wl
lF
wF
wF
nd
nd
nd
nd
nd
nd
nd
"}
(21,1,1) = {"
nd
ms
Qe
Ya
nd
wF
ZB
lF
wl
aK
IJ
aK
aK
wJ
wF
FO
FO
aK
aK
wj
Kn
wF
wF
nd
nd
OH
eT
OH
nd
nd
"}
(22,1,1) = {"
nd
ms
ms
FO
nd
nd
nd
nd
wl
wl
wl
wl
Iy
wl
wl
wl
wl
wl
wl
wl
nd
wF
bm
nd
gV
OH
gV
pP
gV
nd
"}
(23,1,1) = {"
nd
ms
WC
cn
nd
lz
lz
nd
nd
nd
lF
lF
lF
lF
nd
nd
lF
lF
lF
lF
nd
wF
FO
nd
OH
pP
Mo
Mo
pP
nd
"}
(24,1,1) = {"
nd
wF
CN
FO
nd
wF
wF
dc
ms
ms
cn
wF
CO
wF
AT
ms
ms
wF
ms
ms
wF
wF
Tt
wH
OH
JZ
RF
Mo
oN
nd
"}
(25,1,1) = {"
nd
dc
nd
nd
nd
wF
wF
nd
CO
ms
ms
ms
wF
ms
ms
wF
CO
wF
wF
ms
wF
FO
Bt
wH
OH
JZ
Mo
Mo
Gn
nd
"}
(26,1,1) = {"
nd
wF
wF
wF
FO
FO
FO
nd
nd
nd
lF
lF
lF
lF
nd
nd
lF
lF
lF
lF
nd
Ln
cn
nd
pP
OH
Mo
Mo
pP
nd
"}
(27,1,1) = {"
nd
wF
wF
FO
FO
FO
pl
nd
iT
wF
wF
wF
wF
wF
ms
wF
ms
ms
wF
ms
lF
ju
wF
nd
kk
pP
kk
pP
kk
nd
"}
(28,1,1) = {"
nd
dc
nd
lF
lF
lF
nd
nd
wF
wF
pl
wF
ms
ms
FO
FO
FO
Ya
FO
ms
lF
FO
wF
nd
nd
OH
FC
OH
nd
nd
"}
(29,1,1) = {"
nd
wF
wF
Ln
FO
aE
FO
dc
wF
cn
wF
wF
ms
FO
FO
FO
FO
wF
ms
wF
nd
wF
FO
CO
nd
nd
nd
nd
nd
nd
"}
(30,1,1) = {"
nd
nd
nd
nd
nd
nd
nd
nd
nd
nd
nd
nd
nd
nd
FO
gP
FO
nd
nd
nd
nd
nd
nd
Kn
nd
nd
nd
nd
nd
nd
"}

(1,1,2) = {"
LR
LR
LR
LR
LR
LR
LR
LR
LR
LR
LR
LR
LR
lA
lA
lA
lA
yo
lA
LR
LR
LR
LR
LR
LR
LR
LR
LR
LR
LR
"}
(2,1,2) = {"
LR
LR
LR
LR
LR
LR
LR
LR
LR
lA
lA
lA
lA
lA
uB
uB
uB
yo
yo
GC
yo
yo
yo
LR
LR
LR
LR
LR
LR
LR
"}
(3,1,2) = {"
LR
LR
LR
LR
LR
lA
lA
lA
yo
eD
lA
La
lA
lA
tA
Pu
uB
uB
lA
lA
La
lA
GC
lA
LR
LR
LR
LR
LR
LR
"}
(4,1,2) = {"
LR
LR
LR
LR
lA
lA
La
lA
yo
lA
lA
yo
lA
uB
uB
Pu
WG
uB
uB
uB
lA
lA
lA
GC
Ed
LR
LR
LR
LR
LR
"}
(5,1,2) = {"
LR
LR
LR
lA
lA
yo
lA
lA
GC
lA
lA
WG
uB
uB
WG
uB
uB
uB
uB
Pu
uB
uB
uB
lA
yo
lA
LR
LR
LR
LR
"}
(6,1,2) = {"
LR
LR
LR
GC
lA
Jd
yo
yo
lA
lA
WG
uB
uB
uB
WG
uB
uB
uB
WG
uB
Pu
WG
uB
GC
lA
lA
lA
LR
LR
LR
"}
(7,1,2) = {"
LR
LR
LR
lA
GC
lA
lA
La
WG
WG
CL
WG
WG
lA
lA
lA
lA
si
WG
WG
uB
WG
uB
uB
lA
yo
yo
lA
LR
LR
"}
(8,1,2) = {"
LR
LR
LR
lA
yo
lA
lA
WG
WG
uB
WG
lA
lA
yo
yo
yo
lA
lA
lA
WG
uB
uB
tA
uB
uB
eD
yo
lA
LR
LR
"}
(9,1,2) = {"
LR
LR
lA
lA
lA
WG
WG
uB
uB
nd
au
au
nd
nd
UW
UW
NM
nd
au
au
nd
lA
uB
uB
uB
yo
eD
rl
lA
LR
"}
(10,1,2) = {"
LR
LR
lA
lA
WG
Pu
uB
uB
uB
nd
zu
zu
zu
zu
zu
zu
zu
hd
Qm
Qm
nd
lA
WG
uB
uB
lA
yo
yo
lA
LR
"}
(11,1,2) = {"
LR
LR
GC
LB
WG
uB
uB
nd
au
au
hd
hd
hd
hd
hd
hd
hd
hd
Qm
hd
au
lA
Pu
uB
uB
lA
lA
si
yo
LR
"}
(12,1,2) = {"
LR
lA
lA
WG
Hd
uB
WG
NM
Qm
Qm
Qm
Qm
Qm
Qm
Qm
Qm
Qm
Qm
Qm
Qm
au
lA
WG
WG
WG
uB
lA
La
GC
LR
"}
(13,1,2) = {"
lA
si
lA
WG
uB
uB
WG
au
Qm
Qm
Qm
Qm
Qm
Qm
hd
hd
Qm
Qm
Qm
hd
nd
lA
lA
Pu
uB
uB
uB
uB
lA
lA
"}
(14,1,2) = {"
lA
uB
WG
WG
uB
WG
WG
au
Qm
Qm
Qm
hd
hd
Qm
hd
hd
Qm
Qm
Qm
Qm
NM
lA
GC
lA
uB
uB
uB
WG
uB
uB
"}
(15,1,2) = {"
lA
uB
Pu
uB
uB
uB
Pu
nd
yI
hd
Qm
hd
hd
Qm
Qm
Qm
Qm
Qm
Qm
UF
au
lA
yo
lA
WG
WG
uB
WG
uB
uB
"}
(16,1,2) = {"
lA
uB
uB
uB
tA
uB
WG
nd
hd
hd
Qm
Qm
Qm
Qm
Qm
Qm
Qm
Qm
Qm
Vk
au
lA
yo
lA
si
WG
uB
uB
uB
uB
"}
(17,1,2) = {"
lA
WG
Pu
lA
WG
WG
lA
au
hd
hd
Qm
Qm
Qm
Qm
Qm
Qm
Qm
Qm
Qm
yI
NM
lA
lA
yo
GC
WG
uB
WG
WG
lA
"}
(18,1,2) = {"
au
NM
NM
au
au
nd
nd
au
Qm
Qm
Qm
Qm
Qm
Qm
hd
rc
Qm
Qm
Qm
Qm
nd
lA
lA
eD
lA
lA
uB
tA
WG
lA
"}
(19,1,2) = {"
au
Ei
zu
zu
zu
zu
zu
hd
hd
hd
Qm
Qm
Qm
Qm
hd
hd
Qm
Qm
Qm
Qm
au
GC
lA
yo
lA
WG
uB
uB
lA
LR
"}
(20,1,2) = {"
nd
zu
zu
zu
zu
zu
zu
nd
nd
hd
Qm
Qm
Qm
hd
hd
hd
hd
Qm
Qm
Qm
au
lA
lA
WG
WG
uB
uB
lA
lA
LR
"}
(21,1,2) = {"
nd
zu
zu
zu
hd
hd
hd
nd
nd
hd
hd
hd
hd
hd
Ei
zu
hd
Qm
Qm
Qm
nd
Pu
WG
WG
uB
uB
lA
lA
lA
LR
"}
(22,1,2) = {"
au
zu
zu
zu
bG
CA
CA
zu
zu
zu
zu
zu
PZ
zu
zu
hd
Qm
Qm
Qm
Qm
nd
WG
WG
WG
WG
lA
WG
lA
LR
LR
"}
(23,1,2) = {"
au
Ei
zu
zu
bG
Qm
Qm
au
au
NM
nd
au
au
nd
nd
au
au
nd
nd
au
au
uB
Hd
Pu
lA
yo
La
lA
LR
LR
"}
(24,1,2) = {"
LR
nd
zu
zu
bG
Qm
Qm
nd
iR
lA
KI
lA
Rn
lA
lA
lA
WG
WG
lA
uB
uB
uB
Pu
yo
yo
lA
lA
LR
LR
LR
"}
(25,1,2) = {"
LR
nd
Vr
Vr
lL
Qm
Qm
nd
lA
lA
si
yo
eV
lA
GC
lA
lA
uB
uB
uB
uB
lA
lA
rl
si
GC
LR
LR
LR
LR
"}
(26,1,2) = {"
LR
LR
au
Qm
Qm
Qm
Qm
au
iR
lA
mR
lA
eV
lA
GY
im
lA
uB
WG
WG
WG
WG
yo
lA
lA
LR
LR
LR
LR
LR
"}
(27,1,2) = {"
LR
LR
LR
au
nd
Qm
Qm
au
lA
GC
yo
lA
eV
lA
yo
uB
uB
WG
Pu
WG
lA
lA
La
lA
LR
LR
LR
LR
LR
LR
"}
(28,1,2) = {"
LR
LR
LR
LR
LR
nd
nd
NM
KI
lA
mR
lA
eV
GC
lA
uB
uB
WG
WG
lA
lA
yo
lA
LR
LR
LR
LR
LR
LR
LR
"}
(29,1,2) = {"
LR
LR
LR
LR
LR
LR
LR
nd
lA
lA
lA
lA
eV
lA
uB
WG
Pu
WG
lA
rl
yo
LR
LR
LR
LR
LR
LR
LR
LR
LR
"}
(30,1,2) = {"
LR
LR
LR
LR
LR
LR
LR
LR
LR
LR
LR
LR
LR
lA
lA
yo
yo
lA
LR
LR
LR
LR
LR
LR
LR
LR
LR
LR
LR
LR
"}
