//MAP CONVERTED BY dmm2tgm.py THIS HEADER COMMENT PREVENTS RECONVERSION, DO NOT REMOVE
"aK" = (
/obj/structure/table/wood/bar,
/obj/structure/fluff/railing/border{
	icon_state = "border";
	dir = 5
	},
/turf/open/floor/ruinedwood/darker,
/area/rogue/under/cave)
"aT" = (
/obj/structure/window/stained/silver,
/turf/closed/wall/mineral/stonebrick,
/area/rogue/under/cave)
"be" = (
/obj/structure/stairs/stone{
	dir = 1
	},
/obj/structure/stairs/stone,
/turf/open/floor/ruinedwood/darker,
/area/rogue/under/cave)
"ce" = (
/obj/structure/chair/bench/couchablack,
/mob/living/carbon/human/species/skeleton/npc/ambush,
/turf/open/floor/ruinedwood/darker,
/area/rogue/under/cave)
"cg" = (
/obj/structure/fluff/railing/border{
	icon_state = "border";
	dir = 4
	},
/turf/open/floor/ruinedwood/darker,
/area/rogue/under/cave)
"cp" = (
/obj/structure/table/wood/counter/end{
	dir = 8
	},
/turf/open/floor/hexstone,
/area/rogue/under/cave)
"cA" = (
/obj/item/clothing/gloves/chain/iron,
/turf/open/floor/hexstone,
/area/rogue/under/cave)
"cR" = (
/mob/living/carbon/human/species/goblin/npc/ambush/sea,
/turf/open/floor/hexstone,
/area/rogue/under/cave)
"eD" = (
/obj/item/clothing/shoes/boots/armor,
/obj/structure/fluff/walldeco/chains,
/turf/open/floor/hexstone,
/area/rogue/under/cave)
"fd" = (
/obj/structure/fluff/walldeco/bsmith,
/turf/open/floor/hexstone,
/area/rogue/under/cave)
"gI" = (
/obj/structure/fluff/railing/border{
	icon_state = "border";
	dir = 1
	},
/turf/open/floor/ruinedwood/darker,
/area/rogue/under/cave)
"gO" = (
/obj/machinery/light/fueled/torchholder/l,
/turf/open/floor/hexstone,
/area/rogue/under/cave)
"hj" = (
/obj/structure/table/wood/counter{
	dir = 1
	},
/obj/item/reagent_containers/food/snacks/cooked/sausage{
	pixel_x = 12;
	pixel_y = 11
	},
/turf/open/floor/hexstone,
/area/rogue/under/cave)
"hQ" = (
/obj/structure/fluff/railing/border{
	dir = 9;
	icon_state = "border"
	},
/turf/open/floor/ruinedwood/darker,
/area/rogue/under/cave)
"hX" = (
/turf/closed/wall/mineral/stonebrick,
/area/rogue/under/cave)
"if" = (
/mob/living/carbon/human/species/skeleton/npc/warrior,
/turf/open/floor/ruinedwood/darker,
/area/rogue/under/cave)
"iE" = (
/obj/structure/fermentation_keg/random/water,
/turf/open/floor/ruinedwood/darker,
/area/rogue/under/cave)
"iH" = (
/obj/structure/fluff/railing/border{
	icon_state = "border";
	dir = 8
	},
/turf/open/floor/ruinedwood/darker,
/area/rogue/under/cave)
"jd" = (
/obj/effect/decal/cleanable/blood/gibs/limb,
/turf/open/floor/hexstone,
/area/rogue/under/cave)
"jw" = (
/obj/item/weapon/knife/dagger/steel,
/turf/open/floor/hexstone,
/area/rogue/under/cave)
"jD" = (
/obj/machinery/light/fueled/torchholder/l,
/mob/living/carbon/human/species/skeleton/npc/warrior,
/turf/open/floor/hexstone,
/area/rogue/under/cave)
"ka" = (
/obj/structure/chair/bench/church/mid,
/obj/structure/chair/bench/church/mid,
/mob/living/carbon/human/species/skeleton/npc/no_equipment,
/turf/open/floor/ruinedwood/darker,
/area/rogue/under/cave)
"kU" = (
/obj/structure/mineral_door/wood/donjon{
	dir = 4
	},
/obj/structure/mineral_door/wood/donjon{
	dir = 8;
	locked = 1
	},
/turf/closed/wall/mineral/stonebrick,
/area/rogue/under/cave)
"ld" = (
/obj/structure/rack/shelf/biggest,
/obj/item/weapon/polearm/spear/billhook,
/obj/item/weapon/polearm/spear/billhook{
	pixel_y = -8
	},
/turf/open/floor/hexstone,
/area/rogue/under/cave)
"mo" = (
/obj/structure/fluff/railing/border{
	icon_state = "border";
	dir = 1
	},
/obj/structure/chair/bench/church{
	dir = 1
	},
/turf/open/floor/ruinedwood/darker,
/area/rogue/under/cave)
"mH" = (
/obj/structure/table/wood/counter/end,
/obj/item/reagent_containers/food/snacks/cooked/sausage,
/turf/open/floor/hexstone,
/area/rogue/under/cave)
"mL" = (
/obj/structure/mineral_door/wood/donjon{
	dir = 8;
	locked = 1
	},
/turf/open/floor/ruinedwood/darker,
/area/rogue/under/cave)
"mX" = (
/turf/closed/wall/mineral/stone/window/moss,
/area/rogue/under/cave)
"nm" = (
/obj/effect/dungeon_directional_helper/south,
/turf/open/floor/hexstone,
/area/rogue/under/cave)
"oY" = (
/obj/item/ingot/iron,
/obj/item/ingot/iron{
	pixel_y = -2;
	pixel_x = 12
	},
/obj/item/ingot/iron{
	pixel_y = 5;
	pixel_x = 7
	},
/turf/open/floor/hexstone,
/area/rogue/under/cave)
"pA" = (
/obj/structure/fluff/railing/border{
	icon_state = "border";
	dir = 5
	},
/turf/open/floor/ruinedwood/darker,
/area/rogue/under/cave)
"pT" = (
/turf/open/floor/hexstone,
/area/rogue/under/cave)
"qk" = (
/obj/structure/table/wood/counter/end{
	dir = 1
	},
/turf/open/floor/hexstone,
/area/rogue/under/cave)
"qD" = (
/obj/structure/table/wood/counter{
	dir = 1
	},
/obj/item/reagent_containers/food/snacks/cooked/sausage{
	pixel_y = 5;
	pixel_x = -7
	},
/turf/open/floor/hexstone,
/area/rogue/under/cave)
"qQ" = (
/mob/living/carbon/human/species/goblin/npc/hell{
	name = "Bobby Baker"
	},
/turf/open/floor/hexstone,
/area/rogue/under/cave)
"qY" = (
/obj/structure/fluff/railing/border{
	icon_state = "border";
	dir = 1
	},
/obj/structure/chair/bench/church/r,
/turf/open/floor/ruinedwood/darker,
/area/rogue/under/cave)
"rH" = (
/mob/living/carbon/human/species/goblin/npc/hell{
	name = "Weinerman"
	},
/turf/open/floor/hexstone,
/area/rogue/under/cave)
"rW" = (
/obj/structure/table/wood/counter{
	dir = 1
	},
/turf/open/floor/hexstone,
/area/rogue/under/cave)
"ss" = (
/obj/structure/stairs/stone,
/turf/open/floor/hexstone,
/area/rogue/under/cave)
"sM" = (
/obj/item/weapon/sword/arming,
/turf/open/floor/hexstone,
/area/rogue/under/cave)
"tz" = (
/obj/structure/chair/bench/church/smallbench{
	dir = 4
	},
/obj/structure/fluff/railing/border,
/turf/open/floor/ruinedwood/darker,
/area/rogue/under/cave)
"tY" = (
/obj/item/natural/stone{
	pixel_y = 5
	},
/mob/living/carbon/human/species/orc/ambush{
	name = "Slambo"
	},
/turf/open/floor/hexstone,
/area/rogue/under/cave)
"uC" = (
/obj/structure/table/wood/counter{
	dir = 1
	},
/obj/structure/table/wood/counter{
	dir = 1
	},
/obj/item/reagent_containers/food/snacks/cooked/sausage,
/turf/open/floor/hexstone,
/area/rogue/under/cave)
"uU" = (
/obj/effect/decal/cleanable/blood/splatter,
/turf/open/floor/hexstone,
/area/rogue/under/cave)
"vT" = (
/obj/structure/chair/bench/church/smallbench{
	dir = 4
	},
/mob/living/carbon/human/species/skeleton/npc/no_equipment,
/turf/open/floor/ruinedwood/darker,
/area/rogue/under/cave)
"wq" = (
/obj/structure/fluff/railing/border,
/obj/structure/table/vtable,
/obj/item/reagent_containers/glass/cup/golden{
	pixel_y = 8;
	pixel_x = -5
	},
/obj/item/reagent_containers/glass/bottle/redwine{
	pixel_y = 12;
	pixel_x = 7
	},
/turf/open/floor/ruinedwood/darker,
/area/rogue/under/cave)
"xB" = (
/obj/structure/fluff/railing/border{
	icon_state = "border";
	dir = 1
	},
/obj/structure/chair/bench/church/mid,
/mob/living/carbon/human/species/skeleton/npc/no_equipment,
/turf/open/floor/ruinedwood/darker,
/area/rogue/under/cave)
"xO" = (
/obj/structure/mineral_door/wood/donjon{
	dir = 4;
	locked = 1
	},
/turf/closed/wall/mineral/stonebrick,
/area/rogue/under/cave)
"xX" = (
/turf/open/transparent/openspace,
/area/rogue/under/cave)
"yW" = (
/obj/structure/chair/bench/church/mid,
/turf/open/floor/ruinedwood/darker,
/area/rogue/under/cave)
"zL" = (
/mob/living/carbon/human/species/skeleton/npc/peasant,
/turf/open/floor/ruinedwood/darker,
/area/rogue/under/cave)
"zX" = (
/obj/structure/rack/shelf/biggest,
/obj/item/gun/ballistic/revolver/grenadelauncher/bow/long,
/obj/item/ammo_holder/quiver/arrows,
/turf/open/floor/ruinedwood/darker,
/area/rogue/under/cave)
"Bu" = (
/obj/machinery/light/fueled/torchholder/r,
/turf/open/floor/hexstone,
/area/rogue/under/cave)
"BS" = (
/obj/effect/decal/cleanable/blood/gibs,
/turf/open/floor/hexstone,
/area/rogue/under/cave)
"Ci" = (
/obj/structure/mineral_door/wood{
	locked = 1
	},
/turf/open/floor/hexstone,
/area/rogue/under/cave)
"Cr" = (
/obj/structure/fluff/railing/border{
	icon_state = "border";
	dir = 1
	},
/obj/structure/chair/bench/church/mid,
/obj/item/clothing/head/peaceflower,
/mob/living/carbon/human/species/skeleton/npc/no_equipment,
/obj/effect/mapping_helpers/floor_clothing_equipper,
/turf/open/floor/ruinedwood/darker,
/area/rogue/under/cave)
"CJ" = (
/obj/item/clothing/armor/chainmail/iron,
/turf/open/floor/hexstone,
/area/rogue/under/cave)
"CK" = (
/mob/living/carbon/human/species/skeleton/npc/warrior,
/turf/open/floor/hexstone,
/area/rogue/under/cave)
"DJ" = (
/turf/closed/mineral/bedrock,
/area/rogue/under/cave)
"EG" = (
/obj/structure/chair/bench/couchablack/r,
/mob/living/carbon/human/species/skeleton/npc/warrior/skilled{
	name = "Lord of the Pit"
	},
/turf/open/floor/ruinedwood/darker,
/area/rogue/under/cave)
"EH" = (
/obj/structure/table/wood/bar,
/obj/item/reagent_containers/glass/cup/skull,
/turf/open/floor/ruinedwood/darker,
/area/rogue/under/cave)
"GL" = (
/obj/machinery/light/fueled/forge,
/obj/item/weapon/tongs,
/turf/open/floor/hexstone,
/area/rogue/under/cave)
"HQ" = (
/obj/structure/chair/bench/church/smallbench{
	dir = 4
	},
/obj/structure/fluff/railing/border{
	dir = 10;
	icon_state = "border"
	},
/mob/living/carbon/human/species/skeleton/npc/no_equipment,
/turf/open/floor/ruinedwood/darker,
/area/rogue/under/cave)
"Iz" = (
/mob/living/carbon/human/species/orc/warrior,
/turf/open/floor/hexstone,
/area/rogue/under/cave)
"Jk" = (
/obj/structure/fluff/railing/border,
/turf/open/floor/ruinedwood/darker,
/area/rogue/under/cave)
"Ky" = (
/obj/item/natural/stone,
/obj/item/natural/stone,
/obj/item/natural/stone,
/obj/item/natural/stone{
	pixel_y = 10;
	pixel_x = 10
	},
/obj/machinery/anvil,
/obj/item/weapon/hammer/iron,
/turf/open/floor/hexstone,
/area/rogue/under/cave)
"Ll" = (
/obj/structure/bars,
/turf/open/floor/hexstone,
/area/rogue/under/cave)
"LG" = (
/obj/structure/grindwheel,
/turf/open/floor/hexstone,
/area/rogue/under/cave)
"My" = (
/obj/structure/fluff/railing/border,
/obj/structure/table/vtable/v2,
/obj/item/reagent_containers/glass/cup/golden{
	pixel_y = 8;
	pixel_x = 8
	},
/obj/item/weapon/sword/decorated{
	pixel_x = -5;
	pixel_y = 8
	},
/obj/item/gem,
/obj/item/gem{
	pixel_x = -11;
	pixel_y = 11
	},
/turf/open/floor/ruinedwood/darker,
/area/rogue/under/cave)
"MW" = (
/obj/item/ore/coal,
/turf/open/floor/hexstone,
/area/rogue/under/cave)
"Nd" = (
/obj/structure/chair/bench/church/smallbench{
	dir = 4
	},
/mob/living/carbon/human/species/skeleton/npc/peasant,
/turf/open/floor/ruinedwood/darker,
/area/rogue/under/cave)
"Oo" = (
/obj/structure/fluff/railing/border{
	dir = 10;
	icon_state = "border"
	},
/turf/open/floor/ruinedwood/darker,
/area/rogue/under/cave)
"Ot" = (
/obj/structure/chair/bench/church/smallbench{
	dir = 4
	},
/turf/open/floor/ruinedwood/darker,
/area/rogue/under/cave)
"Pq" = (
/obj/effect/decal/cleanable/blood/gibs/up,
/turf/open/floor/hexstone,
/area/rogue/under/cave)
"Pw" = (
/obj/effect/dungeon_directional_helper/west,
/turf/open/floor/hexstone,
/area/rogue/under/cave)
"PG" = (
/obj/structure/fermentation_keg/random/beer,
/turf/open/floor/ruinedwood/darker,
/area/rogue/under/cave)
"PH" = (
/obj/effect/decal/cleanable/blood/footprints,
/turf/open/floor/hexstone,
/area/rogue/under/cave)
"PT" = (
/obj/structure/fluff/walldeco/stone,
/turf/closed/wall/mineral/stone/window/moss,
/area/rogue/under/cave)
"Qa" = (
/obj/structure/fluff/railing/border{
	icon_state = "border";
	dir = 6
	},
/turf/open/floor/ruinedwood/darker,
/area/rogue/under/cave)
"Qp" = (
/obj/structure/chair/bench/church/r,
/turf/open/floor/ruinedwood/darker,
/area/rogue/under/cave)
"Sd" = (
/obj/effect/decal/cleanable/blood/tracks,
/turf/open/floor/hexstone,
/area/rogue/under/cave)
"SV" = (
/obj/item/restraints/legcuffs/beartrap/armed/camouflage,
/turf/open/floor/hexstone,
/area/rogue/under/cave)
"TM" = (
/obj/structure/table/wood/bar,
/turf/open/floor/ruinedwood/darker,
/area/rogue/under/cave)
"TT" = (
/obj/structure/chair/bench/church/mid,
/mob/living/carbon/human/species/skeleton/npc/peasant,
/turf/open/floor/ruinedwood/darker,
/area/rogue/under/cave)
"Ub" = (
/obj/structure/chair/bench/church/smallbench{
	dir = 4
	},
/obj/item/clothing/head/peaceflower,
/mob/living/carbon/human/species/skeleton/npc/no_equipment,
/obj/effect/mapping_helpers/floor_clothing_equipper,
/turf/open/floor/ruinedwood/darker,
/area/rogue/under/cave)
"UI" = (
/turf/open/floor/ruinedwood/darker,
/area/rogue/under/cave)
"UM" = (
/obj/structure/stairs/stone{
	dir = 1
	},
/turf/open/floor/hexstone,
/area/rogue/under/cave)
"UV" = (
/obj/structure/rack/shelf/big,
/turf/open/floor/hexstone,
/area/rogue/under/cave)
"Vl" = (
/obj/structure/table/wood/counter{
	dir = 1
	},
/obj/item/reagent_containers/food/snacks/biscuit_poison,
/obj/item/reagent_containers/food/snacks/biscuit,
/obj/item/reagent_containers/food/snacks/biscuit{
	pixel_x = 12
	},
/obj/item/reagent_containers/food/snacks/biscuit{
	pixel_y = 5;
	pixel_x = 8
	},
/obj/item/reagent_containers/food/snacks/biscuit{
	pixel_y = 12;
	pixel_x = 9
	},
/turf/open/floor/hexstone,
/area/rogue/under/cave)
"Vo" = (
/obj/structure/stairs/stone{
	dir = 1
	},
/turf/open/floor/ruinedwood/darker,
/area/rogue/under/cave)
"Vr" = (
/obj/structure/table/wood/counter{
	dir = 8
	},
/obj/structure/rack/shelf/big,
/obj/item/reagent_containers/glass/cup/silver{
	pixel_x = 6;
	pixel_y = 19
	},
/obj/item/reagent_containers/glass/cup/silver{
	pixel_y = 21;
	pixel_x = -6
	},
/turf/open/floor/ruinedwood/darker,
/area/rogue/under/cave)
"We" = (
/obj/item/weapon/polearm/spear,
/obj/effect/decal/cleanable/blood,
/turf/open/floor/hexstone,
/area/rogue/under/cave)
"Wr" = (
/obj/structure/table/wood/counter{
	dir = 1
	},
/obj/item/reagent_containers/food/snacks/cheese_wedge/aged,
/turf/open/floor/hexstone,
/area/rogue/under/cave)
"Xa" = (
/obj/structure/rack/shelf/biggest,
/obj/item/reagent_containers/glass/bottle/strongpoison,
/turf/open/floor/ruinedwood/darker,
/area/rogue/under/cave)
"Xx" = (
/obj/structure/mineral_door/wood/donjon{
	dir = 4;
	locked = 1
	},
/turf/open/floor/ruinedwood/darker,
/area/rogue/under/cave)
"XA" = (
/turf/open/floor/rooftop{
	dir = 1
	},
/area/rogue/under/cave)
"Za" = (
/mob/living/carbon/human/species/zizombie/npc/ambush,
/obj/item/natural/poo,
/obj/effect/decal/cleanable/blood/splatter,
/turf/open/floor/hexstone,
/area/rogue/under/cave)
"Zh" = (
/obj/effect/decal/cleanable/blood/gibs/core,
/turf/open/floor/hexstone,
/area/rogue/under/cave)
"ZD" = (
/obj/structure/bed/shit,
/turf/open/floor/hexstone,
/area/rogue/under/cave)
"ZW" = (
/obj/structure/chair/bench/church{
	dir = 1
	},
/turf/open/floor/ruinedwood/darker,
/area/rogue/under/cave)
"ZY" = (
/obj/structure/table/wood/counter,
/turf/open/floor/hexstone,
/area/rogue/under/cave)

(1,1,1) = {"
DJ
DJ
DJ
DJ
DJ
DJ
DJ
pT
pT
Pw
pT
pT
DJ
DJ
DJ
DJ
DJ
DJ
DJ
DJ
"}
(2,1,1) = {"
DJ
pT
pT
pT
pT
pT
pT
pT
pT
pT
pT
pT
pT
pT
pT
pT
pT
pT
pT
DJ
"}
(3,1,1) = {"
DJ
pT
fd
pT
pT
oY
mX
pT
pT
pT
mX
mX
mX
mX
pT
pT
pT
mH
pT
DJ
"}
(4,1,1) = {"
DJ
pT
pT
Ky
tY
ld
mX
pT
pT
pT
pT
pT
ss
mX
pT
pT
pT
Vl
pT
DJ
"}
(5,1,1) = {"
DJ
pT
pT
pT
LG
mX
PT
pT
SV
pT
pT
pT
ss
mX
mX
pT
pT
rW
pT
DJ
"}
(6,1,1) = {"
DJ
pT
MW
GL
mX
mX
pT
pT
pT
pT
pT
pT
pT
pT
mX
mX
qQ
Wr
pT
DJ
"}
(7,1,1) = {"
DJ
pT
mX
mX
mX
pT
pT
pT
hX
hX
xO
hX
pT
pT
pT
mX
mX
mX
pT
DJ
"}
(8,1,1) = {"
DJ
pT
pT
pT
pT
pT
pT
hX
pT
cR
Sd
CJ
hX
pT
pT
pT
pT
mX
pT
DJ
"}
(9,1,1) = {"
DJ
pT
pT
pT
pT
pT
hX
jD
BS
We
jd
PH
gO
hX
pT
pT
pT
pT
pT
pT
"}
(10,1,1) = {"
DJ
pT
pT
pT
pT
pT
Ll
eD
pT
jw
pT
Iz
pT
Ll
pT
pT
pT
pT
pT
pT
"}
(11,1,1) = {"
DJ
pT
pT
pT
SV
pT
Ll
Za
Pq
Zh
cA
Iz
pT
Ll
pT
pT
pT
pT
pT
nm
"}
(12,1,1) = {"
DJ
pT
pT
pT
pT
pT
hX
Bu
CK
pT
sM
pT
Bu
hX
pT
SV
pT
pT
pT
pT
"}
(13,1,1) = {"
DJ
pT
pT
pT
pT
pT
pT
hX
pT
pT
pT
uU
hX
pT
pT
pT
pT
mX
pT
DJ
"}
(14,1,1) = {"
DJ
pT
mX
Ci
mX
pT
pT
pT
hX
kU
hX
hX
pT
pT
pT
mX
mX
mX
pT
DJ
"}
(15,1,1) = {"
DJ
pT
mX
pT
mX
mX
pT
pT
pT
pT
pT
pT
pT
pT
mX
mX
pT
hj
pT
DJ
"}
(16,1,1) = {"
DJ
pT
mX
pT
ZD
mX
mX
UM
pT
pT
pT
SV
pT
mX
mX
UV
rH
uC
pT
DJ
"}
(17,1,1) = {"
DJ
pT
mX
pT
pT
ZD
mX
UM
pT
pT
pT
pT
pT
mX
pT
pT
pT
qD
pT
DJ
"}
(18,1,1) = {"
DJ
pT
mX
mX
mX
mX
mX
mX
mX
pT
pT
pT
mX
mX
ZY
cp
pT
qk
pT
DJ
"}
(19,1,1) = {"
DJ
pT
pT
pT
pT
pT
pT
pT
pT
pT
pT
pT
pT
pT
pT
pT
pT
pT
pT
DJ
"}
(20,1,1) = {"
DJ
DJ
DJ
DJ
DJ
DJ
DJ
DJ
DJ
DJ
DJ
DJ
DJ
DJ
DJ
DJ
DJ
DJ
DJ
DJ
"}

(1,1,2) = {"
DJ
DJ
DJ
DJ
DJ
DJ
DJ
hX
UI
UI
UI
hX
DJ
DJ
DJ
DJ
DJ
DJ
DJ
DJ
"}
(2,1,2) = {"
DJ
xX
xX
xX
xX
xX
xX
hX
UI
UI
UI
hX
xX
xX
xX
xX
xX
xX
xX
DJ
"}
(3,1,2) = {"
DJ
xX
xX
xX
xX
xX
hX
hX
UI
UI
UI
hX
hX
hX
hX
xX
xX
xX
xX
DJ
"}
(4,1,2) = {"
DJ
xX
xX
xX
xX
xX
hX
UI
Ot
Ot
Ot
tz
xX
be
hX
xX
xX
xX
xX
DJ
"}
(5,1,2) = {"
DJ
xX
xX
xX
xX
hX
hX
UI
Nd
vT
Ot
tz
xX
be
hX
xX
xX
xX
xX
DJ
"}
(6,1,2) = {"
DJ
xX
xX
xX
hX
hX
UI
UI
Ub
Ot
Ot
HQ
iH
UI
hX
hX
xX
xX
xX
DJ
"}
(7,1,2) = {"
DJ
xX
hX
hX
hX
if
UI
Qa
cg
cg
cg
cg
pA
UI
UI
hX
hX
hX
xX
DJ
"}
(8,1,2) = {"
DJ
xX
hX
Xa
hX
Xx
hX
hX
xX
xX
xX
xX
hX
pA
UI
UI
UI
hX
hX
hX
"}
(9,1,2) = {"
DJ
xX
aT
UI
UI
UI
Jk
xX
xX
xX
xX
xX
xX
mo
ZW
ZW
UI
UI
UI
UI
"}
(10,1,2) = {"
DJ
xX
hX
UI
UI
ce
wq
xX
xX
xX
xX
xX
xX
xB
yW
yW
UI
UI
UI
UI
"}
(11,1,2) = {"
DJ
xX
hX
UI
UI
EG
My
xX
xX
xX
xX
xX
xX
Cr
ka
TT
UI
UI
UI
UI
"}
(12,1,2) = {"
DJ
xX
aT
UI
UI
UI
Jk
xX
xX
xX
xX
xX
xX
qY
Qp
Qp
UI
UI
UI
UI
"}
(13,1,2) = {"
DJ
xX
hX
zX
hX
mL
hX
hX
xX
xX
xX
xX
hX
UI
UI
UI
UI
hX
hX
hX
"}
(14,1,2) = {"
DJ
xX
hX
hX
hX
if
UI
Oo
iH
iH
iH
iH
hQ
UI
UI
hX
hX
hX
xX
DJ
"}
(15,1,2) = {"
DJ
xX
XA
XA
hX
hX
UI
cg
aK
EH
TM
EH
UI
UI
hX
hX
xX
xX
xX
DJ
"}
(16,1,2) = {"
DJ
xX
XA
XA
XA
hX
Vo
xX
gI
UI
UI
UI
UI
hX
hX
xX
xX
xX
xX
DJ
"}
(17,1,2) = {"
DJ
xX
XA
XA
XA
hX
Vo
xX
gI
Vr
zL
iE
PG
hX
xX
xX
xX
xX
xX
DJ
"}
(18,1,2) = {"
DJ
xX
XA
XA
XA
hX
hX
hX
hX
hX
hX
hX
hX
hX
xX
xX
xX
xX
xX
DJ
"}
(19,1,2) = {"
DJ
xX
xX
xX
xX
xX
xX
xX
xX
xX
xX
xX
xX
xX
xX
xX
xX
xX
xX
DJ
"}
(20,1,2) = {"
DJ
DJ
DJ
DJ
DJ
DJ
DJ
DJ
DJ
DJ
DJ
DJ
DJ
DJ
DJ
DJ
DJ
DJ
DJ
DJ
"}
