//MAP CONVERTED BY dmm2tgm.py THIS HEADER COMMENT PREVENTS RECONVERSION, DO NOT REMOVE
"cw" = (
/obj/structure/closet/crate/chest/gold,
/obj/item/gem/green,
/obj/item/gem/red,
/obj/item/gem/yellow,
/turf/open/floor/metal,
/area/rogue/under/cavewet)
"ei" = (
/obj/item/reagent_containers/glass/bottle/whitewine,
/turf/closed/mineral/bedrock,
/area/rogue/under/cavewet)
"es" = (
/obj/structure/mineral_door/wood/donjon{
	dir = 8
	},
/turf/open/floor/metal,
/area/rogue/under/cavewet)
"hz" = (
/turf/open/floor/dirt,
/area/rogue/under/cavewet)
"iA" = (
/obj/machinery/light/fueled/torchholder/r,
/turf/open/floor/dirt,
/area/rogue/under/cavewet)
"jx" = (
/obj/structure/stairs{
	dir = 4
	},
/turf/open/floor/dirt,
/area/rogue/under/cavewet)
"kl" = (
/obj/structure/bars,
/turf/open/floor/metal,
/area/rogue/under/cavewet)
"kH" = (
/mob/living/simple_animal/hostile/retaliate/wolf,
/obj/effect/decal/cleanable/blood/old,
/turf/open/floor/metal,
/area/rogue/under/cavewet)
"lA" = (
/obj/structure/rack/shelf,
/turf/open/floor/ruinedwood/chevron,
/area/rogue/under/cavewet)
"me" = (
/obj/machinery/light/fueled/torchholder{
	dir = 1
	},
/turf/open/floor/dirt,
/area/rogue/under/cavewet)
"nc" = (
/turf/closed/wall/mineral/wooddark,
/area/rogue/under/cavewet)
"ni" = (
/obj/effect/dungeon_directional_helper/east,
/turf/open/floor/dirt,
/area/rogue/under/cavewet)
"ox" = (
/obj/machinery/light/fueled/torchholder/c,
/turf/open/floor/dirt,
/area/rogue/under/cavewet)
"qp" = (
/obj/effect/decal/cleanable/blood,
/turf/open/floor/metal,
/area/rogue/under/cavewet)
"sr" = (
/obj/structure/stairs{
	dir = 4
	},
/turf/open/floor/ruinedwood/chevron,
/area/rogue/under/cavewet)
"tE" = (
/obj/machinery/light/fueled/torchholder/l,
/turf/open/floor/dirt,
/area/rogue/under/cavewet)
"tY" = (
/turf/open/floor/ruinedwood/chevron,
/area/rogue/under/cavewet)
"uc" = (
/obj/structure/fluff/railing/wood{
	dir = 4
	},
/turf/open/floor/ruinedwood/chevron,
/area/rogue/under/cavewet)
"vr" = (
/obj/machinery/light/fueled/torchholder/l,
/turf/open/floor/ruinedwood,
/area/rogue/under/cavewet)
"wX" = (
/obj/effect/decal/cleanable/blood/tracks{
	dir = 4
	},
/turf/open/floor/metal,
/area/rogue/under/cavewet)
"yg" = (
/obj/structure/fluff/railing/wood{
	dir = 1
	},
/turf/open/floor/ruinedwood/chevron,
/area/rogue/under/cavewet)
"yA" = (
/obj/structure/rack/shelf{
	pixel_y = -32
	},
/turf/open/floor/ruinedwood/chevron,
/area/rogue/under/cavewet)
"zo" = (
/obj/effect/decal/cleanable/blood/splatter,
/turf/open/floor/metal,
/area/rogue/under/cavewet)
"zD" = (
/obj/effect/decal/cleanable/vomit/old,
/obj/machinery/light/fueled/torchholder/r,
/turf/open/floor/ruinedwood/chevron,
/area/rogue/under/cavewet)
"zM" = (
/turf/closed/mineral/bedrock,
/area/rogue/under/cavewet)
"AJ" = (
/obj/effect/decal/cleanable/blood/old,
/turf/open/floor/ruinedwood/chevron,
/area/rogue/under/cavewet)
"AL" = (
/obj/item/chair/fancy,
/turf/open/floor/ruinedwood/chevron,
/area/rogue/under/cavewet)
"BP" = (
/turf/closed/wall/mineral/wooddark/vertical,
/area/rogue/under/cavewet)
"Cf" = (
/obj/structure/stairs{
	dir = 4
	},
/turf/open/floor/ruinedwood,
/area/rogue/under/cavewet)
"Cs" = (
/obj/structure/closet/crate/chest/gold,
/obj/item/weapon/sword/sabre/cutlass,
/obj/item/weapon/knife/dagger/silver,
/obj/item/weapon/shield/tower/metal,
/turf/open/floor/metal,
/area/rogue/under/cavewet)
"CT" = (
/obj/item/reagent_containers/glass/bottle/redwine,
/turf/closed/mineral/bedrock,
/area/rogue/under/cavewet)
"DM" = (
/obj/structure/chair/wood/alt/fancy,
/turf/open/floor/ruinedwood/chevron,
/area/rogue/under/cavewet)
"Em" = (
/obj/machinery/light/fueled/firebowl/standing,
/turf/open/transparent/openspace,
/area/rogue/under/cavewet)
"Fh" = (
/obj/effect/decal/cleanable/blood/old,
/turf/open/floor/ruinedwood,
/area/rogue/under/cavewet)
"Fo" = (
/obj/effect/decal/cleanable/glass,
/turf/closed/wall/mineral/wooddark/vertical,
/area/rogue/under/cavewet)
"Ga" = (
/turf/open/floor/metal,
/area/rogue/under/cavewet)
"Ge" = (
/obj/structure/chair/wood/alt/fancy,
/obj/effect/decal/cleanable/dirt,
/turf/open/floor/ruinedwood/chevron,
/area/rogue/under/cavewet)
"Ha" = (
/turf/open/transparent/openspace,
/area/rogue/under/cavewet)
"Hh" = (
/obj/structure/fluff/railing/wood,
/turf/open/floor/ruinedwood/chevron,
/area/rogue/under/cavewet)
"Hr" = (
/turf/open/water/acid/mapped,
/area/rogue/under/cavewet)
"Im" = (
/turf/open/floor/ruinedwood,
/area/rogue/under/cavewet)
"IP" = (
/obj/structure/chair/wood/alt/fancy{
	dir = 8
	},
/turf/open/floor/ruinedwood/chevron,
/area/rogue/under/cavewet)
"Je" = (
/obj/effect/decal/cleanable/dirt,
/obj/item/chair/fancy{
	dir = 4
	},
/turf/open/floor/ruinedwood/chevron,
/area/rogue/under/cavewet)
"JC" = (
/obj/effect/decal/cleanable/blood/tracks{
	dir = 10
	},
/turf/open/floor/metal,
/area/rogue/under/cavewet)
"Ka" = (
/obj/effect/decal/cleanable/blood/old,
/turf/open/floor/metal,
/area/rogue/under/cavewet)
"MC" = (
/obj/structure/mineral_door/wood,
/turf/open/floor/ruinedwood/chevron,
/area/rogue/under/cavewet)
"Nb" = (
/mob/living/simple_animal/hostile/retaliate/wolf,
/obj/effect/decal/cleanable/blood/tracks{
	dir = 4
	},
/turf/open/floor/metal,
/area/rogue/under/cavewet)
"Nv" = (
/obj/effect/dungeon_directional_helper/west,
/turf/open/floor/dirt,
/area/rogue/under/cavewet)
"OI" = (
/obj/structure/mineral_door/wood/donjon{
	dir = 4
	},
/turf/open/floor/metal,
/area/rogue/under/cavewet)
"OY" = (
/obj/machinery/light/fueled/torchholder{
	dir = 1
	},
/turf/open/floor/ruinedwood/chevron,
/area/rogue/under/cavewet)
"Pn" = (
/obj/effect/decal/cleanable/dirt,
/obj/structure/rack/shelf{
	pixel_y = -32
	},
/turf/open/floor/ruinedwood/chevron,
/area/rogue/under/cavewet)
"RS" = (
/obj/machinery/light/fueled/torchholder/c,
/turf/open/floor/ruinedwood/chevron,
/area/rogue/under/cavewet)
"SA" = (
/mob/living/simple_animal/hostile/retaliate/wolf,
/turf/open/floor/metal,
/area/rogue/under/cavewet)
"Tq" = (
/obj/effect/decal/cleanable/dirt,
/turf/open/floor/ruinedwood/chevron,
/area/rogue/under/cavewet)
"Ur" = (
/obj/structure/closet/crate/chest/gold,
/obj/item/clothing/head/helmet/visored/knight,
/obj/item/clothing/gloves/plate,
/turf/open/floor/metal,
/area/rogue/under/cavewet)
"Vk" = (
/obj/structure/chair/wood/alt/fancy{
	dir = 1
	},
/turf/open/floor/ruinedwood/chevron,
/area/rogue/under/cavewet)
"Vy" = (
/obj/machinery/light/fueled/torchholder/l,
/turf/open/floor/ruinedwood/chevron,
/area/rogue/under/cavewet)
"VZ" = (
/turf/open/water,
/area/rogue/under/cavewet)
"Yt" = (
/obj/item/chair/fancy{
	dir = 1
	},
/turf/open/floor/ruinedwood/chevron,
/area/rogue/under/cavewet)
"YC" = (
/obj/structure/chair/wood/alt/fancy,
/obj/effect/decal/cleanable/vomit/old,
/turf/open/floor/ruinedwood/chevron,
/area/rogue/under/cavewet)
"YL" = (
/obj/machinery/light/fueled/torchholder/r,
/turf/open/floor/ruinedwood/chevron,
/area/rogue/under/cavewet)

(1,1,1) = {"
zM
zM
zM
zM
zM
zM
hz
Nv
hz
zM
zM
zM
zM
zM
zM
"}
(2,1,1) = {"
zM
hz
hz
hz
hz
vr
Im
hz
hz
tE
hz
hz
hz
hz
zM
"}
(3,1,1) = {"
zM
hz
hz
hz
Im
hz
Im
hz
Im
hz
hz
Im
Im
Im
zM
"}
(4,1,1) = {"
zM
hz
hz
Hr
Hr
Hr
Fh
Hr
Im
Hr
Hr
Hr
Im
hz
zM
"}
(5,1,1) = {"
zM
hz
Im
Hr
kl
kl
es
kl
es
kl
kl
Hr
hz
hz
zM
"}
(6,1,1) = {"
zM
hz
hz
Hr
kl
Ga
wX
Ga
zo
Ka
kl
Hr
Im
hz
zM
"}
(7,1,1) = {"
zM
hz
Im
Hr
kl
Ga
Nb
VZ
Ga
kH
kl
Hr
Im
Im
zM
"}
(8,1,1) = {"
zM
ox
Im
Hr
kl
Ga
qp
Ga
zo
Ga
kl
Hr
hz
me
zM
"}
(9,1,1) = {"
zM
Im
Im
Hr
kl
SA
Ga
zo
qp
JC
kl
Hr
hz
hz
zM
"}
(10,1,1) = {"
zM
jx
hz
Hr
kl
kH
Ga
Ga
zo
Nb
kl
Hr
Im
Cf
zM
"}
(11,1,1) = {"
zM
nc
hz
Hr
kl
Ka
Ga
qp
Ga
Nb
kl
Hr
hz
nc
zM
"}
(12,1,1) = {"
zM
hz
Im
Hr
kl
Ga
Ga
Ga
Ga
wX
kl
Hr
hz
hz
zM
"}
(13,1,1) = {"
zM
ox
hz
Hr
kl
SA
SA
Ga
Ga
qp
kl
Hr
hz
me
zM
"}
(14,1,1) = {"
zM
hz
hz
Hr
kl
qp
Ga
Ga
Ga
SA
kl
Hr
hz
hz
zM
"}
(15,1,1) = {"
zM
hz
Im
Hr
kl
Ur
Ga
Cs
Ga
cw
kl
Hr
Im
hz
zM
"}
(16,1,1) = {"
zM
Im
Im
Hr
kl
kl
kl
kl
kl
kl
kl
Hr
Im
Im
zM
"}
(17,1,1) = {"
zM
Im
Im
Hr
Hr
Hr
Hr
Hr
Hr
Hr
Hr
Hr
hz
Im
zM
"}
(18,1,1) = {"
zM
hz
Im
hz
Im
hz
hz
Im
hz
hz
Im
Im
hz
hz
zM
"}
(19,1,1) = {"
zM
hz
hz
hz
hz
iA
hz
hz
hz
iA
hz
hz
hz
hz
zM
"}
(20,1,1) = {"
zM
zM
zM
zM
zM
zM
hz
ni
hz
zM
zM
zM
zM
zM
zM
"}

(1,1,2) = {"
zM
zM
zM
zM
zM
zM
tY
tY
tY
zM
zM
zM
zM
zM
zM
"}
(2,1,2) = {"
zM
Fo
BP
BP
BP
nc
MC
nc
MC
nc
BP
BP
BP
BP
zM
"}
(3,1,2) = {"
zM
lA
tY
tY
Vy
tY
tY
tY
tY
tY
Vy
Tq
Tq
yA
ei
"}
(4,1,2) = {"
zM
lA
tY
tY
tY
tY
tY
tY
tY
tY
tY
tY
Tq
Pn
zM
"}
(5,1,2) = {"
zM
lA
tY
tY
kl
kl
kl
OI
kl
kl
kl
tY
tY
yA
zM
"}
(6,1,2) = {"
zM
tY
YC
DM
kl
Ha
Ha
Im
Ha
Ha
kl
Vk
Vk
tY
zM
"}
(7,1,2) = {"
zM
tY
Ge
Je
kl
Ha
Ha
Ha
Ha
Ha
kl
Yt
Vk
tY
zM
"}
(8,1,2) = {"
zM
RS
Yt
DM
kl
Ha
Ha
Em
Ha
Ha
kl
Vk
Vk
OY
zM
"}
(9,1,2) = {"
zM
uc
Ge
DM
kl
Ha
Ha
Ha
Ha
Ha
kl
Vk
Vk
uc
zM
"}
(10,1,2) = {"
zM
Ha
yg
tY
kl
Ha
Ha
Ha
Ha
Ha
kl
tY
Hh
Ha
zM
"}
(11,1,2) = {"
zM
sr
yg
tY
kl
Ha
Ha
Ha
Ha
Ha
kl
tY
Hh
sr
zM
"}
(12,1,2) = {"
zM
AJ
tY
tY
kl
Ha
Ha
Ha
Ha
Ha
kl
tY
tY
tY
zM
"}
(13,1,2) = {"
zM
RS
DM
DM
kl
Ha
Ha
Em
Ha
Ha
kl
AL
Vk
OY
zM
"}
(14,1,2) = {"
zM
tY
DM
YC
kl
Ha
Ha
Ha
Ha
Ha
kl
Vk
Vk
tY
zM
"}
(15,1,2) = {"
zM
tY
DM
Yt
kl
Ha
Ha
Ha
Ha
Ha
kl
Vk
Vk
tY
zM
"}
(16,1,2) = {"
zM
lA
tY
tY
kl
kl
kl
kl
kl
kl
kl
tY
tY
yA
zM
"}
(17,1,2) = {"
zM
lA
tY
tY
tY
IP
IP
tY
IP
IP
tY
tY
Tq
yA
zM
"}
(18,1,2) = {"
CT
lA
tY
tY
zD
IP
Yt
tY
IP
IP
YL
tY
Tq
Pn
zM
"}
(19,1,2) = {"
zM
BP
BP
BP
BP
nc
MC
nc
MC
nc
BP
BP
BP
BP
zM
"}
(20,1,2) = {"
zM
zM
zM
zM
zM
zM
tY
tY
tY
zM
zM
zM
zM
zM
zM
"}
