//MAP CONVERTED BY dmm2tgm.py THIS HEADER COMMENT PREVENTS RECONVERSION, DO NOT REMOVE
"bi" = (
/obj/structure/chair/bench/couch/redright,
/turf/open/floor/ruinedwood/spiralfade,
/area/rogue/indoors/shelter)
"bm" = (
/turf/closed/mineral/bedrock,
/area/rogue/under/cave)
"ch" = (
/obj/structure/closet/crate/crafted_closet/inn/chest,
/turf/open/floor/ruinedwood/spiralfade,
/area/rogue/indoors/shelter)
"cT" = (
/obj/structure/fluff/railing/border{
	dir = 9
	},
/turf/open/floor/ruinedwood/spiralfade,
/area/rogue/indoors/shelter)
"dB" = (
/obj/structure/well,
/turf/open/floor/dirt,
/area/rogue/under/cave)
"dL" = (
/obj/structure/fluff/railing/border{
	dir = 8
	},
/turf/open/floor/ruinedwood/spiralfade,
/area/rogue/indoors/shelter)
"ex" = (
/obj/structure/closet/crate/crafted_closet/inn,
/turf/open/floor/ruinedwood/spiralfade,
/area/rogue/indoors/shelter)
"hf" = (
/obj/structure/bed/inn/double,
/turf/open/floor/ruinedwood/spiralfade,
/area/rogue/indoors/shelter)
"hl" = (
/obj/structure/closet/crate/drawer/inn,
/turf/open/floor/ruinedwood/spiralfade,
/area/rogue/indoors/shelter)
"hq" = (
/obj/structure/floordoor/gatehatch/inner,
/turf/open/floor/dirt,
/area/rogue/under/cave)
"hr" = (
/obj/structure/chair/stool{
	pixel_x = 3;
	pixel_y = -1
	},
/turf/open/floor/ruinedwood/spiralfade,
/area/rogue/indoors/shelter)
"hy" = (
/obj/structure/fluff/railing/border,
/obj/structure/fluff/railing/border,
/turf/open/floor/ruinedwood/spiralfade,
/area/rogue/indoors/shelter)
"hM" = (
/obj/structure/fluff/walldeco/vinez/offset,
/turf/open/floor/ruinedwood/spiralfade,
/area/rogue/indoors/shelter)
"iY" = (
/obj/structure/fluff/railing/border{
	dir = 4
	},
/obj/structure/fluff/railing/border{
	dir = 4
	},
/turf/open/floor/ruinedwood/spiralfade,
/area/rogue/indoors/shelter)
"jn" = (
/obj/structure/chair/wood,
/turf/open/floor/ruinedwood/spiralfade,
/area/rogue/indoors/shelter)
"jJ" = (
/turf/open/floor/naturalstone,
/area/rogue/indoors/shelter)
"jV" = (
/obj/structure/mineral_door/wood,
/obj/item/restraints/legcuffs/beartrap/armed,
/turf/open/floor/ruinedwood/spiralfade,
/area/rogue/indoors/shelter)
"kC" = (
/obj/structure/toilet,
/mob/living/carbon/human/species/orc/npc,
/obj/effect/mapping_helpers/outfit_handler{
	outfit_to_equip = /datum/outfit/job/adventurer/barbarian
	},
/turf/open/floor/ruinedwood/spiralfade,
/area/rogue/indoors/shelter)
"la" = (
/turf/closed/wall/mineral/decowood,
/area/rogue/indoors/shelter)
"mp" = (
/obj/effect/dungeon_directional_helper/south,
/turf/open/floor/naturalstone,
/area/rogue/under/cave)
"mD" = (
/obj/structure/fluff/walldeco/sign/saiga,
/turf/open/floor/dirt,
/area/rogue/under/cave)
"of" = (
/obj/structure/fermentation_keg/random/beer,
/turf/open/floor/ruinedwood/spiralfade,
/area/rogue/indoors/shelter)
"oF" = (
/obj/structure/bars/pipe/left,
/mob/living/carbon/human/species/skeleton/npc/ambush,
/turf/open/water/bath,
/area/rogue/indoors/shelter)
"ph" = (
/obj/structure/fluff/railing/border{
	dir = 1
	},
/turf/open/floor/ruinedwood/spiralfade,
/area/rogue/indoors/shelter)
"pm" = (
/obj/structure/fluff/walldeco/sign/trophy,
/turf/open/floor/ruinedwood/spiralfade,
/area/rogue/indoors/shelter)
"px" = (
/turf/open/floor/rooftop/green{
	dir = 1
	},
/area/rogue/under/cave)
"pU" = (
/turf/open/floor/dirt,
/area/rogue/under/cave)
"qq" = (
/obj/effect/dungeon_directional_helper/east,
/turf/open/floor/naturalstone,
/area/rogue/under/cave)
"qI" = (
/obj/structure/window/openclose{
	dir = 4
	},
/turf/open/floor/ruinedwood/spiralfade,
/area/rogue/indoors/shelter)
"rv" = (
/obj/machinery/light/fueled/torchholder/l,
/obj/structure/fluff/walldeco/vinez/l,
/turf/open/floor/ruinedwood/spiralfade,
/area/rogue/indoors/shelter)
"ug" = (
/obj/structure/table/wood/large_alt,
/obj/item/reagent_containers/glass/cup/wooden/crafted{
	pixel_y = -5;
	pixel_x = 13
	},
/turf/open/floor/ruinedwood/spiralfade,
/area/rogue/indoors/shelter)
"ui" = (
/obj/structure/fluff/walldeco/vinez,
/turf/closed/wall/mineral/decowood/vert,
/area/rogue/indoors/shelter)
"uo" = (
/turf/open/floor/rooftop/green{
	dir = 8
	},
/area/rogue/under/cave)
"uD" = (
/obj/structure/closet/crate/crafted_closet/inn/south,
/turf/open/floor/ruinedwood/spiralfade,
/area/rogue/indoors/shelter)
"vn" = (
/obj/item/bath/soap,
/turf/open/water/bath,
/area/rogue/indoors/shelter)
"vp" = (
/obj/structure/stairs/d{
	dir = 4
	},
/turf/open/floor/ruinedwood/spiralfade,
/area/rogue/indoors/shelter)
"vs" = (
/turf/closed/wall/mineral/stone/moss,
/area/rogue/indoors/shelter)
"vI" = (
/obj/structure/window,
/turf/closed/wall/mineral/decowood,
/area/rogue/indoors/shelter)
"wL" = (
/obj/structure/table/wood/large/corner_alt,
/obj/item/reagent_containers/glass/cup/wooden/crafted{
	pixel_x = -6;
	pixel_y = 16
	},
/turf/open/floor/ruinedwood/spiralfade,
/area/rogue/indoors/shelter)
"wR" = (
/obj/structure/window/openclose{
	dir = 8
	},
/turf/open/floor/ruinedwood/spiralfade,
/area/rogue/indoors/shelter)
"wU" = (
/obj/machinery/light/fueled/oven/west,
/turf/open/floor/ruinedwood/spiralfade,
/area/rogue/indoors/shelter)
"xG" = (
/obj/machinery/light/fueled/hearth,
/obj/item/reagent_containers/glass/bucket/pot,
/turf/open/floor/ruinedwood/spiralfade,
/area/rogue/indoors/shelter)
"yI" = (
/obj/machinery/light/fueled/chand,
/turf/open/transparent/openspace,
/area/rogue/indoors/shelter)
"yW" = (
/obj/machinery/light/fueled/torchholder/r,
/turf/open/floor/ruinedwood/spiralfade,
/area/rogue/indoors/shelter)
"Ae" = (
/obj/item/bath/soap,
/obj/structure/mineral_door/wood/deadbolt{
	dir = 1
	},
/turf/open/floor/ruinedwood/spiralfade,
/area/rogue/indoors/shelter)
"Ao" = (
/obj/structure/table/wood/large/corner_alt,
/turf/open/floor/ruinedwood/spiralfade,
/area/rogue/indoors/shelter)
"Bl" = (
/obj/structure/chair/stool,
/turf/open/floor/ruinedwood/spiralfade,
/area/rogue/indoors/shelter)
"BL" = (
/obj/machinery/light/fueled/hearth,
/obj/item/cooking/pan,
/turf/open/floor/ruinedwood/spiralfade,
/area/rogue/indoors/shelter)
"BT" = (
/obj/structure/bed/bear{
	pixel_x = 0;
	pixel_y = -6
	},
/turf/open/floor/ruinedwood/spiralfade,
/area/rogue/indoors/shelter)
"CL" = (
/obj/structure/fluff/railing/border{
	dir = 6
	},
/turf/open/floor/ruinedwood/spiralfade,
/area/rogue/indoors/shelter)
"Dl" = (
/turf/closed/wall/mineral/stone/moss,
/area/rogue/under/cave)
"EL" = (
/turf/closed/wall/mineral/decowood/vert,
/area/rogue/indoors/shelter)
"Fo" = (
/obj/structure/rack/shelf/big,
/turf/open/floor/ruinedwood/spiralfade,
/area/rogue/indoors/shelter)
"FI" = (
/obj/item/chair/stool/bar,
/turf/open/floor/ruinedwood/spiralfade,
/area/rogue/indoors/shelter)
"GK" = (
/obj/effect/dungeon_directional_helper/north,
/turf/open/floor/naturalstone,
/area/rogue/under/cave)
"GW" = (
/obj/structure/chair/bench/couch/redleft,
/turf/open/floor/ruinedwood/spiralfade,
/area/rogue/indoors/shelter)
"He" = (
/obj/structure/table/wood/large_alt,
/obj/item/reagent_containers/glass/cup/wooden/crafted{
	pixel_x = 9
	},
/turf/open/floor/ruinedwood/spiralfade,
/area/rogue/indoors/shelter)
"Hm" = (
/obj/machinery/light/fueled/chand,
/obj/item/clothing/ring/silver,
/turf/open/transparent/openspace,
/area/rogue/indoors/shelter)
"Hp" = (
/turf/open/floor/dirt,
/area/rogue/indoors/shelter)
"HO" = (
/obj/structure/fluff/walldeco/vinez/l,
/turf/open/floor/ruinedwood/spiralfade,
/area/rogue/indoors/shelter)
"HR" = (
/turf/open/floor/rooftop/green,
/area/rogue/under/cave)
"Ij" = (
/obj/structure/mineral_door/wood,
/turf/open/floor/ruinedwood/spiralfade,
/area/rogue/indoors/shelter)
"Iy" = (
/obj/machinery/light/fueled/wallfire{
	pixel_x = 16
	},
/turf/closed/wall/mineral/decowood/vert,
/area/rogue/indoors/shelter)
"IM" = (
/turf/open/transparent/openspace,
/area/rogue/under/cave)
"IQ" = (
/obj/effect/dungeon_directional_helper/west,
/turf/open/floor/naturalstone,
/area/rogue/under/cave)
"Jg" = (
/obj/structure/chair/stool{
	pixel_x = -5
	},
/turf/open/floor/ruinedwood/spiralfade,
/area/rogue/indoors/shelter)
"Jk" = (
/turf/open/water/bath,
/area/rogue/indoors/shelter)
"JS" = (
/obj/structure/rack/shelf/biggest,
/obj/item/reagent_containers/food/snacks/meat/salami{
	pixel_y = -2;
	pixel_x = -1
	},
/obj/item/reagent_containers/food/snacks/meat/salami{
	pixel_x = -2;
	pixel_y = 10
	},
/turf/open/floor/ruinedwood/spiralfade,
/area/rogue/indoors/shelter)
"Kc" = (
/obj/structure/window/openclose{
	dir = 1
	},
/turf/open/floor/ruinedwood/spiralfade,
/area/rogue/indoors/shelter)
"Km" = (
/obj/structure/table/wood/large/corner_alt,
/obj/item/reagent_containers/food/snacks/rotten/sausage{
	pixel_y = 4
	},
/turf/open/floor/ruinedwood/spiralfade,
/area/rogue/indoors/shelter)
"KZ" = (
/turf/open/floor/naturalstone,
/area/rogue/under/cave)
"Lu" = (
/turf/open/floor/rooftop/green{
	dir = 4
	},
/area/rogue/under/cave)
"LB" = (
/obj/structure/window,
/obj/structure/fluff/walldeco/vinez,
/turf/closed/wall/mineral/decowood/vert,
/area/rogue/indoors/shelter)
"LU" = (
/obj/structure/fluff/walldeco/vinez,
/obj/structure/window,
/turf/closed/wall/mineral/decowood/vert,
/area/rogue/indoors/shelter)
"LZ" = (
/obj/structure/chair/wood{
	dir = 4
	},
/turf/open/floor/ruinedwood/spiralfade,
/area/rogue/indoors/shelter)
"Mk" = (
/turf/open/floor/ruinedwood/spiralfade,
/area/rogue/indoors/shelter)
"My" = (
/obj/structure/table/wood/plain,
/obj/item/reagent_containers/glass/bottle/wine/sourwine{
	pixel_y = 9
	},
/obj/item/reagent_containers/glass/bottle/wine/sourwine{
	pixel_y = 5;
	pixel_x = -7
	},
/obj/item/reagent_containers/glass/bottle/poison{
	pixel_y = 7;
	pixel_x = 8
	},
/turf/open/floor/ruinedwood/spiralfade,
/area/rogue/indoors/shelter)
"MF" = (
/obj/machinery/light/fueled/torchholder/l,
/turf/open/floor/ruinedwood/spiralfade,
/area/rogue/indoors/shelter)
"Ok" = (
/obj/structure/window/openclose,
/turf/open/floor/ruinedwood/spiralfade,
/area/rogue/indoors/shelter)
"Pa" = (
/obj/structure/table/wood/plain,
/obj/item/weapon/knife/cleaver,
/obj/structure/fluff/walldeco/bigpainting/lake,
/turf/open/floor/ruinedwood/spiralfade,
/area/rogue/indoors/shelter)
"Pc" = (
/obj/structure/table/wood/counter{
	dir = 4
	},
/turf/open/floor/ruinedwood/spiralfade,
/area/rogue/indoors/shelter)
"Pn" = (
/obj/structure/fluff/railing/border{
	dir = 5
	},
/turf/open/floor/ruinedwood/spiralfade,
/area/rogue/indoors/shelter)
"Sn" = (
/mob/living/carbon/human/species/skeleton/npc/ambush,
/turf/open/water/bath,
/area/rogue/indoors/shelter)
"TY" = (
/obj/structure/bed/inn,
/turf/open/floor/ruinedwood/spiralfade,
/area/rogue/indoors/shelter)
"Ur" = (
/obj/structure/fluff/walldeco/painting/queen,
/turf/closed/wall/mineral/stone/moss,
/area/rogue/indoors/shelter)
"UV" = (
/obj/structure/fluff/walldeco/bath/wallpipes,
/turf/open/floor/ruinedwood/spiralfade,
/area/rogue/indoors/shelter)
"Vv" = (
/obj/structure/fluff/railing/border,
/turf/open/floor/ruinedwood/spiralfade,
/area/rogue/indoors/shelter)
"Vx" = (
/obj/structure/table/wood/counter{
	dir = 4
	},
/obj/item/reagent_containers/glass/cup/wooden/crafted{
	pixel_x = -6;
	pixel_y = 16
	},
/obj/item/reagent_containers/glass/cup/wooden/crafted{
	pixel_y = -8
	},
/obj/item/reagent_containers/glass/cup/wooden/crafted{
	pixel_x = 4;
	pixel_y = 14
	},
/turf/open/floor/ruinedwood/spiralfade,
/area/rogue/indoors/shelter)
"VY" = (
/obj/structure/fluff/walldeco/vinez/r,
/turf/open/floor/ruinedwood/spiralfade,
/area/rogue/indoors/shelter)
"Wy" = (
/obj/effect/mapping_helpers/outfit_handler{
	outfit_to_equip = /datum/outfit/job/adventurer/barbarian
	},
/mob/living/carbon/human/species/orc/npc,
/turf/open/floor/ruinedwood/spiralfade,
/area/rogue/indoors/shelter)
"WA" = (
/obj/structure/fluff/railing/border{
	dir = 4
	},
/turf/open/floor/ruinedwood/spiralfade,
/area/rogue/indoors/shelter)
"WZ" = (
/obj/structure/mineral_door/wood/window,
/turf/open/floor/ruinedwood/spiralfade,
/area/rogue/indoors/shelter)
"Xw" = (
/obj/structure/fluff/railing/border{
	dir = 10
	},
/turf/open/floor/ruinedwood/spiralfade,
/area/rogue/indoors/shelter)
"Yx" = (
/obj/item/reagent_containers/powder/moondust{
	pixel_x = 5
	},
/obj/item/reagent_containers/powder/moondust{
	pixel_y = -5;
	pixel_x = -13
	},
/obj/item/reagent_containers/powder/moondust{
	pixel_y = 12;
	pixel_x = -7
	},
/obj/effect/decal/cleanable/blood,
/obj/item/weapon/knife/hunting{
	pixel_y = -2;
	pixel_x = -14
	},
/turf/open/floor/ruinedwood/spiralfade,
/area/rogue/indoors/shelter)
"Zo" = (
/turf/open/transparent/openspace,
/area/rogue/indoors/shelter)

(1,1,1) = {"
bm
bm
bm
bm
bm
bm
bm
bm
bm
IQ
KZ
bm
bm
bm
bm
bm
bm
bm
bm
bm
"}
(2,1,1) = {"
bm
KZ
KZ
pU
pU
pU
pU
pU
pU
KZ
KZ
pU
pU
pU
pU
pU
pU
pU
pU
bm
"}
(3,1,1) = {"
bm
KZ
KZ
pU
pU
pU
pU
pU
mD
KZ
KZ
pU
mD
pU
pU
pU
hq
pU
KZ
bm
"}
(4,1,1) = {"
bm
KZ
KZ
vs
vs
vs
qI
vs
vs
WZ
WZ
vs
vs
qI
vs
vs
vs
pU
KZ
bm
"}
(5,1,1) = {"
bm
pU
pU
vs
GW
Ao
FI
Mk
EL
Mk
Mk
Mk
Mk
Mk
Mk
Mk
vs
pU
pU
bm
"}
(6,1,1) = {"
bm
KZ
pU
vs
bi
Ao
Bl
Mk
Iy
Jg
BT
Mk
jn
ug
Km
Mk
vs
pU
pU
bm
"}
(7,1,1) = {"
bm
KZ
pU
Ok
Mk
Mk
jJ
Mk
EL
hr
Mk
Mk
Mk
He
wL
Mk
Kc
pU
KZ
bm
"}
(8,1,1) = {"
bm
pU
pU
vs
la
la
la
Mk
EL
pm
Mk
Mk
Mk
Mk
LZ
Mk
Kc
pU
pU
bm
"}
(9,1,1) = {"
bm
pU
pU
Ur
Mk
Mk
Mk
Mk
Mk
Hp
Hp
Mk
Mk
Mk
Mk
Mk
vs
pU
KZ
bm
"}
(10,1,1) = {"
KZ
KZ
KZ
WZ
Hp
Mk
Mk
Mk
Mk
Hp
Mk
Mk
Mk
Mk
Mk
Mk
WZ
KZ
KZ
KZ
"}
(11,1,1) = {"
GK
KZ
KZ
WZ
Mk
Mk
Mk
Mk
Mk
Mk
Mk
Bl
FI
Bl
Mk
Mk
WZ
KZ
KZ
mp
"}
(12,1,1) = {"
bm
pU
KZ
vs
Mk
Mk
Mk
vs
vs
jV
vs
Vx
Pc
Pc
Pc
Pc
vs
pU
pU
bm
"}
(13,1,1) = {"
bm
pU
pU
Ok
Mk
Hp
Mk
vs
ch
Mk
vs
Fo
Mk
Mk
Mk
of
vs
pU
dB
bm
"}
(14,1,1) = {"
bm
KZ
pU
vs
vp
vp
Mk
vs
ch
Wy
vs
Pa
Mk
Mk
Mk
of
Kc
pU
pU
bm
"}
(15,1,1) = {"
bm
pU
pU
vs
vs
vs
Mk
vs
JS
Mk
vs
My
Mk
Mk
Mk
Mk
Kc
pU
KZ
bm
"}
(16,1,1) = {"
bm
pU
pU
vs
vs
vs
Ij
vs
ex
Mk
Ij
Mk
wU
wU
BL
xG
vs
pU
pU
bm
"}
(17,1,1) = {"
bm
pU
pU
vs
vs
kC
Mk
vs
vs
vs
vs
vs
vs
vs
vs
wR
vs
pU
pU
bm
"}
(18,1,1) = {"
bm
pU
pU
pU
Dl
Dl
Dl
Dl
pU
pU
pU
KZ
pU
pU
pU
pU
pU
pU
pU
bm
"}
(19,1,1) = {"
bm
pU
pU
pU
pU
pU
pU
pU
KZ
KZ
pU
pU
pU
KZ
pU
pU
KZ
pU
pU
bm
"}
(20,1,1) = {"
bm
bm
bm
bm
bm
bm
bm
bm
qq
KZ
bm
bm
bm
bm
bm
bm
bm
bm
bm
bm
"}

(1,1,2) = {"
bm
bm
bm
bm
bm
bm
bm
bm
bm
IM
IM
bm
bm
bm
bm
bm
bm
bm
bm
bm
"}
(2,1,2) = {"
bm
IM
IM
IM
IM
IM
IM
IM
IM
IM
IM
IM
IM
IM
IM
IM
IM
IM
IM
bm
"}
(3,1,2) = {"
bm
IM
IM
uo
uo
uo
uo
uo
uo
uo
uo
uo
uo
uo
uo
uo
uo
IM
IM
bm
"}
(4,1,2) = {"
bm
IM
px
vs
la
la
vI
EL
la
vI
EL
la
la
EL
la
vI
vs
HR
IM
bm
"}
(5,1,2) = {"
bm
IM
px
EL
uD
Mk
Mk
EL
hl
HO
EL
hl
Mk
EL
hl
HO
EL
HR
IM
bm
"}
(6,1,2) = {"
bm
IM
px
EL
hf
hl
Mk
EL
TY
Mk
EL
TY
Zo
EL
TY
Mk
EL
HR
IM
bm
"}
(7,1,2) = {"
bm
IM
px
EL
la
la
Ij
EL
la
Ij
EL
la
Ij
EL
la
Ij
EL
HR
IM
bm
"}
(8,1,2) = {"
bm
IM
px
EL
Mk
rv
CL
WA
WA
WA
WA
iY
WA
Pn
MF
Mk
EL
HR
IM
bm
"}
(9,1,2) = {"
bm
IM
px
EL
Mk
Zo
Vv
Zo
Zo
Zo
Zo
Zo
Zo
ph
Zo
Mk
ui
HR
IM
bm
"}
(10,1,2) = {"
IM
IM
px
ui
Mk
Mk
hy
Zo
Hm
Zo
Zo
yI
Zo
ph
Mk
Zo
LU
HR
IM
IM
"}
(11,1,2) = {"
IM
IM
px
EL
hM
Mk
Zo
Zo
Zo
Zo
Zo
Zo
Zo
ph
Mk
Mk
EL
HR
IM
IM
"}
(12,1,2) = {"
bm
IM
px
ui
Zo
Mk
Xw
dL
dL
dL
dL
dL
dL
cT
Mk
Mk
EL
HR
IM
bm
"}
(13,1,2) = {"
bm
IM
px
EL
Mk
Mk
Mk
EL
la
la
Ij
EL
EL
EL
EL
EL
EL
HR
IM
bm
"}
(14,1,2) = {"
bm
IM
px
EL
Zo
Zo
Mk
EL
hf
Mk
Mk
EL
uD
Mk
Sn
Jk
EL
HR
IM
bm
"}
(15,1,2) = {"
bm
IM
px
EL
vp
vp
Mk
EL
Mk
Mk
Mk
EL
UV
Yx
Jk
vn
LB
HR
IM
bm
"}
(16,1,2) = {"
bm
IM
px
EL
yW
VY
VY
EL
uD
Mk
Mk
Ae
Mk
Mk
oF
Jk
EL
HR
IM
bm
"}
(17,1,2) = {"
bm
IM
px
vs
la
la
la
la
la
vI
la
la
la
la
la
la
vs
HR
IM
bm
"}
(18,1,2) = {"
bm
IM
IM
Lu
Lu
Lu
Lu
Lu
Lu
Lu
Lu
Lu
Lu
Lu
Lu
Lu
Lu
IM
IM
bm
"}
(19,1,2) = {"
bm
IM
IM
IM
IM
IM
IM
IM
IM
IM
IM
IM
IM
IM
IM
IM
IM
IM
IM
bm
"}
(20,1,2) = {"
bm
bm
bm
bm
bm
bm
bm
bm
IM
IM
bm
bm
bm
bm
bm
bm
bm
bm
bm
bm
"}
