//MAP CONVERTED BY dmm2tgm.py THIS HEADER COMMENT PREVENTS RECONVERSION, DO NOT REMOVE
"aw" = (
/obj/effect/spawner/map_spawner/loot/rare,
/turf/open/floor/dirt,
/area/rogue/under/cavewet)
"aY" = (
/obj/structure/flora/grass/water/reeds,
/turf/open/water,
/area/rogue/under/cavewet)
"be" = (
/mob/living/carbon/human/species/goblin/npc/cave,
/turf/open/floor/dirt,
/area/rogue/under/cavewet)
"bg" = (
/obj/structure/barricade/rogue,
/turf/open/floor/dirt,
/area/rogue/under/cavewet)
"bx" = (
/mob/living/carbon/human/species/goblin/npc/cave,
/turf/open/floor/grass/cold,
/area/rogue/under/cavewet)
"bW" = (
/obj/structure/mineral_door/wood/donjon/stone,
/obj/effect/dungeon_directional_helper/north,
/turf/open/floor/dirt,
/area/rogue/under/cavewet)
"cW" = (
/obj/machinery/light/fueled/hearth,
/obj/machinery/light/fueled/oven/east,
/turf/open/floor/dirt,
/area/rogue/under/cavewet)
"dN" = (
/obj/machinery/light/fueled/firebowl,
/turf/open/floor/snow/patchy,
/area/rogue/under/cavewet)
"fA" = (
/obj/structure/chair/stool,
/turf/open/floor/grass/cold,
/area/rogue/under/cavewet)
"fS" = (
/turf/open/floor/snow,
/area/rogue/under/mountains)
"hR" = (
/obj/structure/fluff/railing/wood{
	dir = 4
	},
/obj/structure/fluff/railing/wood,
/turf/open/floor/grass/cold,
/area/rogue/under/cavewet)
"hS" = (
/obj/structure/table/wood,
/obj/item/reagent_containers/glass/bottle/wine,
/turf/open/floor/grass/cold,
/area/rogue/under/cavewet)
"hZ" = (
/obj/machinery/light/fueled/hearth,
/obj/machinery/light/fueled/oven/east,
/obj/item/cooking/pan,
/turf/open/floor/dirt,
/area/rogue/under/cavewet)
"iG" = (
/obj/machinery/light/fueled/firebowl,
/turf/open/floor/snow/patchy,
/area/rogue/under/mountains)
"iO" = (
/turf/open/floor/ruinedwood,
/area/rogue/under/cavewet)
"kD" = (
/obj/structure/fluff/railing/border,
/turf/open/floor/metal,
/area/rogue/under/cavewet)
"la" = (
/obj/structure/table/wood,
/obj/item/reagent_containers/food/snacks/meat/salami,
/turf/open/floor/dirt,
/area/rogue/under/cavewet)
"lu" = (
/obj/machinery/light/fueled/campfire,
/obj/item/reagent_containers/food/snacks/meat/salami,
/turf/open/floor/grass/cold,
/area/rogue/under/mountains)
"mV" = (
/obj/structure/flora/newtree/snow,
/turf/open/floor/grass/cold,
/area/rogue/under/cavewet)
"mX" = (
/obj/structure/fluff/railing/wood{
	dir = 8
	},
/obj/structure/fluff/railing/wood,
/turf/open/floor/dirt,
/area/rogue/under/cavewet)
"no" = (
/obj/structure/table/wood/treestump,
/turf/open/floor/grass/cold,
/area/rogue/under/mountains)
"nC" = (
/obj/structure/fluff/railing/wood{
	dir = 1
	},
/obj/structure/fluff/railing/wood{
	dir = 4
	},
/turf/open/floor/grass/cold,
/area/rogue/under/cavewet)
"ol" = (
/obj/structure/stairs/stone{
	dir = 1
	},
/turf/open/floor/snow,
/area/rogue/under/mountains)
"oN" = (
/turf/open/floor/snow/patchy,
/area/rogue/under/mountains)
"pE" = (
/obj/machinery/light/fueled/firebowl,
/turf/open/floor/dirt,
/area/rogue/under/cavewet)
"rk" = (
/obj/structure/table/wood,
/obj/item/reagent_containers/glass/bottle/redwine,
/turf/open/floor/grass/cold,
/area/rogue/under/cavewet)
"rl" = (
/obj/structure/bed/shit,
/mob/living/carbon/human/species/goblin/npc/cave,
/turf/open/floor/dirt,
/area/rogue/under/cavewet)
"si" = (
/obj/structure/fluff/railing/wood{
	dir = 1
	},
/obj/structure/fluff/railing/wood{
	dir = 8
	},
/turf/open/floor/dirt,
/area/rogue/under/cavewet)
"tl" = (
/obj/effect/spawner/map_spawner/loot/magic,
/turf/open/floor/dirt,
/area/rogue/under/cavewet)
"tH" = (
/obj/structure/table/wood,
/obj/structure/fluff/millstone,
/obj/item/weapon/knife/dagger,
/turf/open/floor/dirt,
/area/rogue/under/cavewet)
"uB" = (
/turf/closed/wall/mineral/tent,
/area/rogue/under/cavewet)
"uD" = (
/turf/open/water/river,
/area/rogue/under/cavewet)
"vd" = (
/obj/structure/roguetent,
/turf/open/floor/dirt,
/area/rogue/under/cavewet)
"vJ" = (
/obj/structure/closet/crate/chest/wicker,
/obj/machinery/light/fueled/wallfire/candle,
/obj/item/gem/yellow,
/turf/open/floor/dirt,
/area/rogue/under/cavewet)
"wl" = (
/turf/open/water,
/area/rogue/under/cavewet)
"wM" = (
/obj/structure/fluff/railing/wood{
	dir = 4
	},
/turf/open/floor/snow,
/area/rogue/under/mountains)
"wQ" = (
/obj/structure/bed/shit,
/turf/open/floor/dirt,
/area/rogue/under/cavewet)
"wX" = (
/obj/effect/dungeon_directional_helper/west,
/turf/open/floor/dirt,
/area/rogue/under/cavewet)
"xm" = (
/obj/structure/fluff/statue/tdummy,
/turf/open/floor/dirt,
/area/rogue/under/cavewet)
"xC" = (
/turf/open/floor/grass/cold,
/area/rogue/under/cavewet)
"yb" = (
/obj/effect/decal/cleanable/blood,
/turf/open/floor/dirt,
/area/rogue/under/cavewet)
"yz" = (
/obj/structure/fluff/railing/wood{
	dir = 4
	},
/turf/open/floor/grass/cold,
/area/rogue/under/cavewet)
"zu" = (
/obj/structure/flora/newtree/snow,
/turf/open/floor/snow,
/area/rogue/under/mountains)
"Ai" = (
/turf/open/water/river{
	dir = 8
	},
/area/rogue/under/cavewet)
"Aq" = (
/obj/structure/mineral_door/wood/donjon/stone,
/turf/open/floor/dirt,
/area/rogue/under/cavewet)
"AB" = (
/mob/living/simple_animal/hostile/orc/spear2,
/turf/open/floor/snow/patchy,
/area/rogue/under/cavewet)
"Bg" = (
/obj/structure/fluff/railing/wood{
	dir = 4
	},
/turf/open/floor/dirt,
/area/rogue/under/cavewet)
"BB" = (
/obj/effect/decal/cleanable/blood/drip,
/turf/open/floor/dirt,
/area/rogue/under/cavewet)
"BC" = (
/obj/item/fishing/bait/meat,
/obj/item/fishing/bait/meat,
/obj/item/fishing/bait/meat,
/obj/item/fishing/bait/meat,
/obj/item/fishing/bait/meat,
/obj/item/fishing/bait/meat,
/obj/item/fishing/bait/meat,
/turf/open/floor/ruinedwood,
/area/rogue/under/cavewet)
"CO" = (
/turf/closed/mineral/bedrock,
/area/rogue/under/mountains)
"Dj" = (
/obj/machinery/light/fueled/firebowl,
/turf/open/floor/grass/cold,
/area/rogue/under/cavewet)
"DA" = (
/obj/structure/fluff/statue/tdummy,
/turf/open/floor/grass/cold,
/area/rogue/under/cavewet)
"DL" = (
/obj/structure/closet/crate/chest/wicker,
/obj/item/flashlight/flare/torch/lantern/bronzelamptern,
/obj/item/flashlight/flare/torch/lantern/bronzelamptern,
/obj/machinery/light/fueled/wallfire/candle,
/turf/open/floor/dirt,
/area/rogue/under/cavewet)
"EU" = (
/obj/structure/table/wood/treestump,
/turf/open/floor/snow,
/area/rogue/under/mountains)
"Fm" = (
/obj/structure/chair/stool,
/turf/open/floor/grass/cold,
/area/rogue/under/mountains)
"GR" = (
/obj/structure/flora/newtree/snow,
/turf/open/floor/grass/cold,
/area/rogue/under/mountains)
"Hl" = (
/obj/effect/spawner/map_spawner/loot/rare,
/turf/open/floor/grass/cold,
/area/rogue/under/cavewet)
"HX" = (
/turf/open/water/river{
	dir = 4
	},
/area/rogue/under/cavewet)
"Jv" = (
/turf/open/transparent/openspace,
/area/rogue/under/mountains)
"KO" = (
/turf/open/floor/snow/patchy,
/area/rogue/under/cavewet)
"Ma" = (
/obj/structure/fluff/railing/border{
	dir = 1
	},
/turf/open/floor/metal,
/area/rogue/under/cavewet)
"Mz" = (
/obj/structure/mineral_door/wood/donjon/stone,
/obj/effect/dungeon_directional_helper/east,
/turf/open/floor/dirt,
/area/rogue/under/cavewet)
"NI" = (
/obj/structure/fluff/railing/wood,
/obj/structure/fluff/railing/wood{
	dir = 4
	},
/turf/open/floor/snow/patchy,
/area/rogue/under/mountains)
"NX" = (
/obj/structure/fluff/railing/wood{
	dir = 1
	},
/turf/open/floor/grass/cold,
/area/rogue/under/cavewet)
"OQ" = (
/turf/open/floor/ruinedwood/turned/darker,
/area/rogue/under/cavewet)
"Pn" = (
/turf/open/floor/snow,
/area/rogue/under/cavewet)
"Qs" = (
/obj/structure/chair/stool,
/obj/item/fishingrod,
/obj/item/fishing/bait,
/turf/open/floor/ruinedwood,
/area/rogue/under/cavewet)
"QA" = (
/turf/closed/mineral/bedrock,
/area/rogue/under/cavewet)
"RS" = (
/obj/structure/closet/crate/chest/crate,
/obj/item/reagent_containers/glass/bottle/waterskin,
/obj/item/reagent_containers/food/snacks/cheese,
/obj/item/reagent_containers/food/snacks/cheese,
/obj/item/reagent_containers/food/snacks/cheese,
/obj/item/reagent_containers/food/snacks/cheese,
/turf/open/floor/dirt,
/area/rogue/under/cavewet)
"Sq" = (
/obj/structure/fluff/railing/wood,
/turf/open/floor/snow,
/area/rogue/under/mountains)
"SA" = (
/obj/structure/fluff/railing/wood{
	dir = 8
	},
/turf/open/floor/dirt,
/area/rogue/under/cavewet)
"Tl" = (
/turf/open/floor/grass/cold,
/area/rogue/under/mountains)
"TM" = (
/obj/structure/table/wood,
/turf/open/floor/grass/cold,
/area/rogue/under/cavewet)
"Ub" = (
/obj/structure/fermentation_keg/random/beer,
/turf/open/floor/grass/cold,
/area/rogue/under/cavewet)
"Um" = (
/obj/item/weapon/mace/woodclub,
/turf/open/floor/grass/cold,
/area/rogue/under/cavewet)
"Uu" = (
/obj/structure/fluff/railing/wood,
/turf/open/floor/snow/patchy,
/area/rogue/under/mountains)
"UM" = (
/obj/structure/fermentation_keg/random/water,
/turf/open/floor/grass/cold,
/area/rogue/under/cavewet)
"UN" = (
/obj/structure/stairs/stone{
	dir = 4
	},
/turf/open/floor/snow,
/area/rogue/under/mountains)
"Vc" = (
/obj/structure/mineral_door/wood/donjon/stone,
/obj/effect/dungeon_directional_helper/south,
/turf/open/floor/dirt,
/area/rogue/under/cavewet)
"Vr" = (
/obj/structure/fluff/railing/wood,
/turf/open/floor/grass/cold,
/area/rogue/under/cavewet)
"VZ" = (
/obj/structure/stairs/stone{
	dir = 4
	},
/turf/open/floor/snow,
/area/rogue/under/cavewet)
"Wp" = (
/obj/effect/spawner/map_spawner/loot/potion_vitals,
/turf/open/floor/grass/cold,
/area/rogue/under/cavewet)
"WV" = (
/mob/living/simple_animal/hostile/orc/orc_marauder,
/turf/open/floor/snow/patchy,
/area/rogue/under/cavewet)
"Xk" = (
/obj/structure/fermentation_keg/random/beer,
/obj/item/reagent_containers/glass/cup/golden,
/turf/open/floor/dirt,
/area/rogue/under/cavewet)
"Xp" = (
/turf/open/floor/dirt,
/area/rogue/under/cavewet)
"XY" = (
/obj/machinery/light/fueled/firebowl,
/turf/open/floor/snow,
/area/rogue/under/mountains)
"Yp" = (
/obj/effect/decal/cleanable/blood/drip,
/obj/item/weapon/polearm/spear/billhook,
/obj/item/clothing/head/crown/circlet/sleepless,
/obj/effect/spawner/map_spawner/loot/coin/absurd,
/obj/effect/spawner/map_spawner/loot/potion_vitals,
/obj/effect/mapping_helpers/floor_clothing_equipper,
/mob/living/carbon/human/species/goblin/npc{
	TOTALCON = 20;
	TOTALEND = 20;
	TOTALINT = 20;
	TOTALLUC = 20;
	TOTALPER = 20;
	TOTALSPD = 20;
	name = "Level 1 Goblin"
	},
/turf/open/floor/dirt,
/area/rogue/under/cavewet)
"YL" = (
/obj/structure/stairs/stone{
	dir = 1
	},
/turf/open/floor/snow,
/area/rogue/under/cavewet)
"ZF" = (
/obj/structure/fluff/railing/wood,
/obj/structure/fluff/railing/wood{
	dir = 4
	},
/turf/open/floor/snow,
/area/rogue/under/mountains)

(1,1,1) = {"
QA
QA
QA
QA
QA
QA
QA
QA
QA
QA
QA
QA
QA
Xp
wX
Xp
QA
QA
QA
QA
QA
QA
QA
QA
QA
QA
QA
QA
QA
QA
"}
(2,1,1) = {"
QA
HX
wl
wl
wl
QA
QA
QA
Xp
Xp
Xp
Xp
Xp
Xp
Xp
Xp
Xp
Xp
Xp
QA
YL
Pn
Pn
Pn
Pn
wl
wl
uD
uD
QA
"}
(3,1,1) = {"
QA
uD
uD
HX
wl
wl
wl
QA
QA
Xp
Xp
pE
Xp
xC
xC
xC
xC
QA
QA
QA
YL
Pn
Pn
Pn
aY
wl
wl
Ai
aY
QA
"}
(4,1,1) = {"
QA
wl
wl
HX
aY
wl
wl
Pn
QA
QA
xC
xC
xC
Pn
Pn
QA
QA
QA
Pn
Pn
Pn
Pn
Pn
wl
wl
aY
uD
Ai
wl
QA
"}
(5,1,1) = {"
QA
wl
aY
HX
wl
wl
Pn
Pn
Pn
QA
QA
QA
Pn
Pn
QA
QA
Pn
Pn
Pn
Pn
Pn
Pn
Pn
wl
uD
uD
Ai
wl
wl
QA
"}
(6,1,1) = {"
QA
wl
wl
HX
wl
wl
wl
wl
Pn
Pn
Pn
Pn
Pn
Pn
Pn
Pn
Pn
Pn
Pn
Pn
wl
wl
aY
wl
Ai
wl
wl
wl
QA
QA
"}
(7,1,1) = {"
QA
QA
wl
uD
uD
uD
HX
wl
aY
wl
wl
Pn
Ma
OQ
kD
Pn
wl
wl
wl
wl
wl
uD
uD
uD
Ai
aY
wl
Xp
Xp
QA
"}
(8,1,1) = {"
QA
QA
QA
wl
wl
wl
uD
uD
uD
HX
wl
wl
Ma
OQ
kD
wl
aY
uD
uD
uD
uD
Ai
wl
wl
wl
wl
QA
QA
Xp
QA
"}
(9,1,1) = {"
QA
Xk
QA
Pn
Pn
wl
wl
wl
wl
uD
uD
uD
Ma
OQ
kD
uD
uD
Ai
wl
wl
aY
wl
wl
Pn
xC
xC
QA
Xp
Xp
QA
"}
(10,1,1) = {"
QA
be
QA
Pn
xC
xC
xC
wl
wl
wl
wl
aY
Ma
OQ
kD
wl
wl
wl
wl
Pn
Pn
xC
xC
xC
xC
xC
QA
Xp
xC
QA
"}
(11,1,1) = {"
QA
bg
QA
xC
KO
KO
xC
xC
xC
Pn
Pn
Pn
Ma
OQ
kD
Pn
Pn
Pn
Pn
xC
xC
xC
KO
KO
KO
xC
QA
xC
xC
QA
"}
(12,1,1) = {"
QA
bg
QA
xC
KO
KO
KO
KO
KO
xC
Pn
Pn
Pn
Pn
Pn
Pn
Pn
Pn
xC
xC
xC
AB
KO
dN
KO
xC
QA
xC
xC
QA
"}
(13,1,1) = {"
QA
Xp
QA
QA
xC
KO
dN
WV
KO
xC
Pn
Pn
Pn
Pn
Pn
Pn
Pn
Pn
Pn
xC
KO
KO
KO
KO
xC
xC
QA
xC
xC
QA
"}
(14,1,1) = {"
bW
Xp
pE
QA
xC
KO
KO
KO
xC
Pn
Pn
Pn
VZ
VZ
VZ
Pn
Pn
Pn
Pn
xC
KO
KO
xC
xC
xC
QA
QA
xC
Xp
Vc
"}
(15,1,1) = {"
QA
Xp
Xp
QA
QA
xC
xC
xC
Pn
Pn
QA
QA
QA
QA
QA
QA
QA
QA
Pn
Pn
Pn
Pn
Pn
xC
QA
QA
pE
Xp
Xp
QA
"}
(16,1,1) = {"
Aq
Xp
Xp
Xp
QA
QA
Pn
Pn
Pn
QA
QA
tH
la
hZ
cW
RS
RS
QA
QA
QA
Pn
Pn
QA
QA
QA
Xp
Xp
Xp
Xp
Aq
"}
(17,1,1) = {"
QA
Xp
Xp
Xp
Xp
Pn
Pn
Pn
Pn
Pn
Xp
Xp
Xp
Xp
xC
xC
xC
Xp
Pn
Pn
Pn
Pn
Pn
Pn
Xp
Xp
Xp
be
Xp
QA
"}
(18,1,1) = {"
QA
Xp
Xp
uB
uB
uB
uB
Pn
Pn
Xp
Xp
Xp
xC
xC
xC
xC
xC
xC
Xp
Xp
Pn
Pn
Pn
Xp
Xp
Xp
iO
iO
iO
QA
"}
(19,1,1) = {"
QA
Xp
Xp
uB
wQ
Xp
uB
uB
Xp
pE
Xp
UM
TM
xC
bx
TM
Ub
xC
Xp
Xp
Xp
pE
Xp
Xp
Xp
Xp
iO
iO
iO
QA
"}
(20,1,1) = {"
QA
Xp
Xp
uB
DL
Xp
Xp
vd
Xp
Xp
xC
TM
hS
TM
TM
rk
TM
xC
Xp
Xp
Xp
Xp
Xp
Xp
Xp
wl
iO
iO
BC
QA
"}
(21,1,1) = {"
QA
Xp
Xp
uB
rl
Xp
uB
uB
Xp
Xp
xC
xC
fA
fA
fA
fA
Xp
Xp
Xp
Xp
xm
Xp
Xp
aY
wl
wl
iO
Qs
iO
QA
"}
(22,1,1) = {"
QA
Xp
Xp
uB
uB
uB
uB
Xp
Xp
Xp
Xp
Xp
Xp
Xp
Xp
Xp
Xp
Xp
Xp
xC
xC
xC
wl
wl
wl
wl
wl
wl
wl
QA
"}
(23,1,1) = {"
QA
Xp
Xp
Xp
Xp
Xp
Xp
Xp
Xp
Xp
si
SA
SA
SA
SA
SA
SA
mX
xC
DA
xC
wl
wl
wl
wl
wl
wl
wl
wl
QA
"}
(24,1,1) = {"
QA
Xp
uB
uB
uB
uB
Xp
Xp
Xp
xC
NX
Um
Xp
yb
Xp
BB
tl
Vr
xC
xC
xC
wl
wl
wl
aY
Xp
xC
xC
wl
QA
"}
(25,1,1) = {"
QA
Xp
uB
wQ
Xp
uB
uB
Xp
xC
xC
NX
Hl
Xp
Xp
Yp
Xp
xC
Vr
xC
xC
aY
wl
wl
wl
xC
xC
Dj
xC
wl
QA
"}
(26,1,1) = {"
QA
Xp
uB
vJ
Xp
Xp
vd
Xp
xC
xC
NX
xC
Xp
aw
Xp
Wp
xC
Vr
xC
Xp
wl
wl
wl
xC
xC
mV
xC
xC
wl
QA
"}
(27,1,1) = {"
QA
Xp
uB
wQ
Xp
uB
uB
Xp
xC
xC
nC
Bg
Bg
Bg
yz
yz
yz
hR
Xp
Xp
wl
wl
aY
xC
xC
xC
Xp
wl
wl
QA
"}
(28,1,1) = {"
QA
Xp
uB
uB
uB
uB
Xp
Xp
pE
Xp
Xp
Xp
Xp
Xp
xC
xC
Xp
Xp
Xp
pE
wl
wl
wl
wl
Xp
Xp
wl
aY
wl
QA
"}
(29,1,1) = {"
QA
Xp
Xp
Xp
Xp
Xp
Xp
Xp
Xp
Xp
Xp
Xp
Xp
Xp
Xp
Xp
Xp
Xp
Xp
wl
wl
wl
wl
wl
wl
wl
wl
wl
wl
QA
"}
(30,1,1) = {"
QA
QA
QA
QA
QA
QA
QA
QA
QA
QA
QA
QA
QA
QA
Mz
QA
Aq
QA
QA
QA
QA
QA
QA
QA
QA
QA
QA
QA
QA
QA
"}

(1,1,2) = {"
CO
CO
CO
CO
CO
CO
CO
CO
CO
CO
CO
CO
CO
fS
oN
fS
fS
CO
CO
CO
CO
CO
CO
CO
CO
CO
CO
CO
CO
CO
"}
(2,1,2) = {"
CO
Jv
Jv
Jv
Jv
fS
fS
fS
fS
fS
fS
oN
oN
Tl
Tl
oN
fS
fS
fS
ol
Jv
Jv
Jv
Jv
Jv
Jv
Jv
Jv
Jv
CO
"}
(3,1,2) = {"
CO
Jv
Jv
Jv
Jv
Jv
Jv
fS
fS
fS
Tl
Tl
Tl
Tl
Tl
Tl
oN
fS
fS
ol
Jv
Jv
Jv
Jv
Jv
Jv
Jv
Jv
Jv
CO
"}
(4,1,2) = {"
CO
Jv
Jv
Jv
Jv
Jv
Jv
Jv
fS
fS
oN
Fm
lu
Fm
Tl
oN
oN
fS
Jv
Jv
Jv
Jv
Jv
Jv
Jv
Jv
Jv
Jv
Jv
CO
"}
(5,1,2) = {"
CO
Jv
Jv
Jv
Jv
Jv
Jv
Jv
Jv
fS
oN
Tl
Tl
Tl
Tl
oN
Jv
Jv
Jv
Jv
Jv
Jv
Jv
Jv
Jv
Jv
Jv
Jv
Jv
CO
"}
(6,1,2) = {"
CO
Jv
Jv
Jv
Jv
Jv
Jv
Jv
Jv
Jv
Jv
Jv
Jv
Jv
Jv
Jv
Jv
Jv
Jv
Jv
Jv
Jv
Jv
Jv
Jv
Jv
Jv
Jv
zu
CO
"}
(7,1,2) = {"
CO
fS
Jv
Jv
Jv
Jv
Jv
Jv
Jv
Jv
Jv
Jv
Jv
Jv
Jv
Jv
Jv
Jv
Jv
Jv
Jv
Jv
Jv
Jv
Jv
Jv
Jv
fS
fS
CO
"}
(8,1,2) = {"
CO
fS
fS
Jv
Jv
Jv
Jv
Jv
Jv
Jv
Jv
Jv
Jv
Jv
Jv
Jv
Jv
Jv
Jv
Jv
Jv
Jv
Jv
Jv
Jv
Jv
fS
fS
fS
CO
"}
(9,1,2) = {"
CO
fS
fS
Jv
Jv
Jv
Jv
Jv
Jv
Jv
Jv
Jv
Jv
Jv
Jv
Jv
Jv
Jv
Jv
Jv
Jv
Jv
Jv
Jv
Jv
Jv
fS
XY
fS
CO
"}
(10,1,2) = {"
CO
zu
fS
Jv
Jv
Jv
Jv
Jv
Jv
Jv
Jv
Jv
Jv
Jv
Jv
Jv
Jv
Jv
Jv
Jv
Jv
Jv
Jv
Jv
Jv
Jv
fS
fS
fS
CO
"}
(11,1,2) = {"
CO
fS
fS
Jv
Jv
Jv
Jv
Jv
Jv
Jv
Jv
Jv
Jv
Jv
Jv
Jv
Jv
Jv
Jv
Jv
Jv
Jv
Jv
Jv
Jv
Jv
fS
fS
fS
CO
"}
(12,1,2) = {"
CO
fS
fS
Jv
Jv
Jv
Jv
Jv
Jv
Jv
Jv
Jv
Jv
Jv
Jv
Jv
Jv
Jv
Jv
Jv
Jv
Jv
Jv
Jv
Jv
Jv
fS
fS
fS
CO
"}
(13,1,2) = {"
CO
fS
fS
zu
Jv
Jv
Jv
Jv
Jv
Jv
Jv
Jv
Jv
Jv
Jv
Jv
Jv
Jv
Jv
Jv
Jv
Jv
Jv
Jv
Jv
Jv
fS
fS
fS
CO
"}
(14,1,2) = {"
oN
oN
fS
fS
Jv
Jv
Jv
Jv
Jv
Jv
Jv
Jv
Jv
Jv
Jv
Jv
Jv
Jv
Jv
Jv
Jv
Jv
Jv
Jv
Jv
fS
fS
fS
fS
fS
"}
(15,1,2) = {"
oN
oN
oN
fS
fS
Jv
Jv
Jv
Jv
Jv
fS
fS
UN
UN
UN
Tl
Tl
fS
Jv
Jv
Jv
Jv
Jv
Jv
fS
fS
fS
fS
fS
fS
"}
(16,1,2) = {"
fS
oN
oN
fS
fS
fS
fS
fS
fS
fS
fS
fS
Tl
oN
oN
Tl
fS
fS
fS
fS
fS
fS
fS
fS
fS
fS
fS
fS
fS
fS
"}
(17,1,2) = {"
CO
oN
oN
Tl
Tl
fS
fS
fS
Tl
Tl
Tl
Tl
Tl
oN
oN
Tl
fS
fS
fS
oN
oN
fS
fS
fS
fS
fS
fS
wM
wM
CO
"}
(18,1,2) = {"
CO
oN
oN
oN
oN
Tl
Tl
Tl
Tl
no
Tl
Tl
oN
oN
oN
Tl
Tl
fS
oN
oN
oN
fS
fS
fS
fS
wM
ZF
Jv
Jv
CO
"}
(19,1,2) = {"
CO
fS
oN
oN
oN
oN
Tl
Tl
Tl
Tl
Tl
Tl
oN
oN
Tl
Tl
Tl
fS
oN
oN
EU
fS
fS
XY
ZF
Jv
Jv
Jv
Jv
CO
"}
(20,1,2) = {"
CO
fS
fS
Tl
oN
oN
oN
oN
Tl
Tl
Tl
oN
oN
Tl
Tl
no
Tl
fS
fS
fS
fS
fS
wM
ZF
Jv
Jv
Jv
Jv
Jv
CO
"}
(21,1,2) = {"
CO
fS
fS
Tl
Tl
oN
oN
oN
oN
oN
Tl
oN
oN
Tl
Tl
Tl
Tl
fS
fS
fS
wM
ZF
Jv
Jv
Jv
Jv
Jv
Jv
Jv
CO
"}
(22,1,2) = {"
CO
fS
fS
Tl
Tl
Tl
Tl
oN
oN
oN
oN
oN
oN
Tl
Tl
Tl
Tl
fS
fS
ZF
Jv
Jv
Jv
Jv
Jv
Jv
Jv
Jv
Jv
CO
"}
(23,1,2) = {"
CO
fS
fS
Tl
no
Tl
Tl
Tl
Tl
oN
oN
oN
Tl
GR
Tl
Tl
oN
oN
Sq
Jv
Jv
Jv
Jv
Jv
Jv
Jv
Jv
Jv
Jv
CO
"}
(24,1,2) = {"
CO
fS
fS
fS
Tl
Tl
Tl
no
Tl
Tl
oN
oN
Tl
Tl
Tl
Tl
oN
iG
Uu
Jv
Jv
Jv
Jv
Jv
Jv
Jv
Jv
Jv
Jv
CO
"}
(25,1,2) = {"
CO
fS
fS
fS
oN
oN
Tl
Tl
Tl
Tl
oN
oN
Tl
Tl
Tl
Tl
fS
oN
NI
Jv
Jv
Jv
Jv
Jv
Jv
Jv
Jv
Jv
Jv
CO
"}
(26,1,2) = {"
CO
fS
fS
oN
oN
oN
Tl
Tl
Tl
Tl
oN
oN
Tl
no
Tl
Tl
fS
Sq
Jv
Jv
Jv
Jv
Jv
Jv
Jv
Jv
Jv
Jv
Jv
CO
"}
(27,1,2) = {"
CO
fS
fS
oN
oN
fS
fS
fS
Tl
Tl
oN
oN
Tl
Tl
Tl
fS
fS
Sq
Jv
Jv
Jv
Jv
Jv
Jv
Jv
Jv
Jv
Jv
Jv
CO
"}
(28,1,2) = {"
CO
CO
fS
fS
fS
fS
fS
fS
fS
fS
oN
oN
oN
oN
oN
oN
fS
Sq
Jv
Jv
Jv
Jv
Jv
Jv
Jv
Jv
Jv
Jv
Jv
CO
"}
(29,1,2) = {"
CO
CO
CO
fS
fS
fS
fS
fS
fS
fS
fS
oN
oN
oN
oN
oN
oN
Sq
Jv
Jv
Jv
Jv
Jv
Jv
Jv
Jv
Jv
Jv
Jv
CO
"}
(30,1,2) = {"
CO
CO
CO
CO
CO
CO
CO
CO
CO
CO
CO
CO
CO
CO
fS
oN
oN
CO
CO
CO
CO
CO
CO
CO
CO
CO
CO
CO
CO
CO
"}
