//MAP CONVERTED BY dmm2tgm.py THIS HEADER COMMENT PREVENTS RECONVERSION, DO NOT REMOVE
"aw" = (
/obj/effect/spawner/map_spawner/loot/rare,
/turf/open/floor/dirt,
/area/rogue)
"aY" = (
/obj/structure/flora/grass/water/reeds,
/turf/open/water,
/area/rogue)
"be" = (
/mob/living/carbon/human/species/goblin/npc/cave,
/turf/open/floor/dirt,
/area/rogue)
"bg" = (
/obj/structure/barricade/rogue,
/turf/open/floor/dirt,
/area/rogue)
"bx" = (
/mob/living/carbon/human/species/goblin/npc/cave,
/turf/open/floor/grass/cold,
/area/rogue)
"bW" = (
/obj/structure/mineral_door/wood/donjon/stone,
/obj/effect/dungeon_directional_helper/north,
/turf/open/floor/dirt,
/area/rogue)
"cW" = (
/obj/machinery/light/fueled/hearth,
/obj/machinery/light/fueled/oven/east,
/turf/open/floor/dirt,
/area/rogue)
"dN" = (
/obj/machinery/light/fueled/firebowl,
/turf/open/floor/snow/patchy,
/area/rogue)
"fA" = (
/obj/structure/chair/stool,
/turf/open/floor/grass/cold,
/area/rogue)
"fS" = (
/turf/open/floor/snow,
/area/rogue)
"hR" = (
/obj/structure/fluff/railing/wood{
	dir = 4
	},
/obj/structure/fluff/railing/wood,
/turf/open/floor/grass/cold,
/area/rogue)
"hS" = (
/obj/structure/table/wood,
/obj/item/reagent_containers/glass/bottle/wine,
/turf/open/floor/grass/cold,
/area/rogue)
"hZ" = (
/obj/machinery/light/fueled/hearth,
/obj/machinery/light/fueled/oven/east,
/obj/item/cooking/pan,
/turf/open/floor/dirt,
/area/rogue)
"iO" = (
/turf/open/floor/ruinedwood,
/area/rogue)
"kD" = (
/obj/structure/fluff/railing/border,
/turf/open/floor/metal,
/area/rogue)
"la" = (
/obj/structure/table/wood,
/obj/item/reagent_containers/food/snacks/meat/salami,
/turf/open/floor/dirt,
/area/rogue)
"lu" = (
/obj/machinery/light/fueled/campfire,
/obj/item/reagent_containers/food/snacks/meat/salami,
/turf/open/floor/grass/cold,
/area/rogue)
"mV" = (
/obj/structure/flora/newtree/snow,
/turf/open/floor/grass/cold,
/area/rogue)
"mX" = (
/obj/structure/fluff/railing/wood{
	dir = 8
	},
/obj/structure/fluff/railing/wood,
/turf/open/floor/dirt,
/area/rogue)
"no" = (
/obj/structure/table/wood/treestump,
/turf/open/floor/grass/cold,
/area/rogue)
"nC" = (
/obj/structure/fluff/railing/wood{
	dir = 1
	},
/obj/structure/fluff/railing/wood{
	dir = 4
	},
/turf/open/floor/grass/cold,
/area/rogue)
"pE" = (
/obj/machinery/light/fueled/firebowl,
/turf/open/floor/dirt,
/area/rogue)
"rk" = (
/obj/structure/table/wood,
/obj/item/reagent_containers/glass/bottle/redwine,
/turf/open/floor/grass/cold,
/area/rogue)
"rl" = (
/obj/structure/bed/shit,
/mob/living/carbon/human/species/goblin/npc/cave,
/turf/open/floor/dirt,
/area/rogue)
"si" = (
/obj/structure/fluff/railing/wood{
	dir = 1
	},
/obj/structure/fluff/railing/wood{
	dir = 8
	},
/turf/open/floor/dirt,
/area/rogue)
"tl" = (
/obj/effect/spawner/map_spawner/loot/magic,
/turf/open/floor/dirt,
/area/rogue)
"tH" = (
/obj/structure/table/wood,
/obj/structure/fluff/millstone,
/obj/item/weapon/knife/dagger,
/turf/open/floor/dirt,
/area/rogue)
"uB" = (
/turf/closed/wall/mineral/tent,
/area/rogue)
"uD" = (
/turf/open/water/river,
/area/rogue)
"vd" = (
/obj/structure/roguetent,
/turf/open/floor/dirt,
/area/rogue)
"vJ" = (
/obj/structure/closet/crate/chest/wicker,
/obj/machinery/light/fueled/wallfire/candle,
/obj/effect/spawner/map_spawner/loot/coin/low,
/turf/open/floor/dirt,
/area/rogue)
"wl" = (
/turf/open/water,
/area/rogue)
"wM" = (
/obj/structure/fluff/railing/wood{
	dir = 4
	},
/turf/open/floor/snow,
/area/rogue)
"wQ" = (
/obj/structure/bed/shit,
/turf/open/floor/dirt,
/area/rogue)
"wX" = (
/obj/effect/dungeon_directional_helper/west,
/turf/open/floor/dirt,
/area/rogue)
"xm" = (
/obj/structure/fluff/statue/tdummy,
/turf/open/floor/dirt,
/area/rogue)
"xC" = (
/turf/open/floor/grass/cold,
/area/rogue)
"yb" = (
/obj/effect/decal/cleanable/blood,
/turf/open/floor/dirt,
/area/rogue)
"yz" = (
/obj/structure/fluff/railing/wood{
	dir = 4
	},
/turf/open/floor/grass/cold,
/area/rogue)
"zu" = (
/obj/structure/flora/newtree/snow,
/turf/open/floor/snow,
/area/rogue)
"Ai" = (
/turf/open/water/river{
	dir = 8
	},
/area/rogue)
"Aq" = (
/obj/structure/mineral_door/wood/donjon/stone,
/turf/open/floor/dirt,
/area/rogue)
"AB" = (
/mob/living/simple_animal/hostile/orc/spear2,
/turf/open/floor/snow/patchy,
/area/rogue)
"Bg" = (
/obj/structure/fluff/railing/wood{
	dir = 4
	},
/turf/open/floor/dirt,
/area/rogue)
"BB" = (
/obj/effect/decal/cleanable/blood/drip,
/turf/open/floor/dirt,
/area/rogue)
"BC" = (
/obj/item/fishing/bait/meat,
/obj/item/fishing/bait/meat,
/obj/item/fishing/bait/meat,
/obj/item/fishing/bait/meat,
/obj/item/fishing/bait/meat,
/obj/item/fishing/bait/meat,
/obj/item/fishing/bait/meat,
/turf/open/floor/ruinedwood,
/area/rogue)
"CO" = (
/turf/closed/mineral/bedrock,
/area/rogue)
"Dj" = (
/obj/machinery/light/fueled/firebowl,
/turf/open/floor/grass/cold,
/area/rogue)
"DA" = (
/obj/structure/fluff/statue/tdummy,
/turf/open/floor/grass/cold,
/area/rogue)
"DL" = (
/obj/structure/closet/crate/chest/wicker,
/obj/item/flashlight/flare/torch/lantern/bronzelamptern,
/obj/item/flashlight/flare/torch/lantern/bronzelamptern,
/obj/machinery/light/fueled/wallfire/candle,
/turf/open/floor/dirt,
/area/rogue)
"EU" = (
/obj/structure/table/wood/treestump,
/turf/open/floor/snow,
/area/rogue)
"Hl" = (
/obj/effect/spawner/map_spawner/loot/rare,
/turf/open/floor/grass/cold,
/area/rogue)
"HX" = (
/turf/open/water/river{
	dir = 4
	},
/area/rogue)
"Jv" = (
/turf/open/transparent/openspace,
/area/rogue)
"KO" = (
/turf/open/floor/snow/patchy,
/area/rogue)
"Ma" = (
/obj/structure/fluff/railing/border{
	dir = 1
	},
/turf/open/floor/metal,
/area/rogue)
"Mz" = (
/obj/structure/mineral_door/wood/donjon/stone,
/obj/effect/dungeon_directional_helper/east,
/turf/open/floor/dirt,
/area/rogue)
"NI" = (
/obj/structure/fluff/railing/wood,
/obj/structure/fluff/railing/wood{
	dir = 4
	},
/turf/open/floor/snow/patchy,
/area/rogue)
"NX" = (
/obj/structure/fluff/railing/wood{
	dir = 1
	},
/turf/open/floor/grass/cold,
/area/rogue)
"OQ" = (
/turf/open/floor/ruinedwood/turned/darker,
/area/rogue)
"Qs" = (
/obj/structure/chair/stool,
/obj/item/fishingrod,
/obj/item/fishing/bait,
/turf/open/floor/ruinedwood,
/area/rogue)
"RS" = (
/obj/structure/closet/crate/chest/crate,
/obj/item/reagent_containers/glass/bottle/waterskin,
/obj/item/reagent_containers/food/snacks/cheese,
/obj/item/reagent_containers/food/snacks/cheese,
/obj/item/reagent_containers/food/snacks/cheese,
/obj/item/reagent_containers/food/snacks/cheese,
/turf/open/floor/dirt,
/area/rogue)
"Sq" = (
/obj/structure/fluff/railing/wood,
/turf/open/floor/snow,
/area/rogue)
"SA" = (
/obj/structure/fluff/railing/wood{
	dir = 8
	},
/turf/open/floor/dirt,
/area/rogue)
"TM" = (
/obj/structure/table/wood,
/turf/open/floor/grass/cold,
/area/rogue)
"Ub" = (
/obj/structure/fermentation_keg/random/beer,
/turf/open/floor/grass/cold,
/area/rogue)
"Um" = (
/obj/item/weapon/mace/woodclub,
/turf/open/floor/grass/cold,
/area/rogue)
"Uu" = (
/obj/structure/fluff/railing/wood,
/turf/open/floor/snow/patchy,
/area/rogue)
"UM" = (
/obj/structure/fermentation_keg/random/water,
/turf/open/floor/grass/cold,
/area/rogue)
"UN" = (
/obj/structure/stairs/stone{
	dir = 4
	},
/turf/open/floor/snow,
/area/rogue)
"Vc" = (
/obj/structure/mineral_door/wood/donjon/stone,
/obj/effect/dungeon_directional_helper/south,
/turf/open/floor/dirt,
/area/rogue)
"Vr" = (
/obj/structure/fluff/railing/wood,
/turf/open/floor/grass/cold,
/area/rogue)
"Wp" = (
/obj/effect/spawner/map_spawner/loot/potion_vitals,
/turf/open/floor/grass/cold,
/area/rogue)
"WV" = (
/mob/living/simple_animal/hostile/orc/orc_marauder,
/turf/open/floor/snow/patchy,
/area/rogue)
"Xk" = (
/obj/structure/fermentation_keg/random/beer,
/obj/item/reagent_containers/glass/cup/golden,
/turf/open/floor/dirt,
/area/rogue)
"Xp" = (
/turf/open/floor/dirt,
/area/rogue)
"XY" = (
/obj/machinery/light/fueled/firebowl,
/turf/open/floor/snow,
/area/rogue)
"Yp" = (
/obj/effect/decal/cleanable/blood/drip,
/mob/living/carbon/human/species/goblin{
	STACON = 20;
	STAEND = 20;
	STAINT = 20;
	STALUC = 20;
	STAPER = 20;
	STASPD = 20;
	STASTR = 20;
	TOTALSTR = 20;
	TOTALSPD = 20;
	TOTALPER = 20;
	TOTALLUC = 20;
	TOTALINT = 20;
	TOTALEND = 20;
	TOTALCON = 20;
	name = "level 1 goblin"
	},
/obj/item/weapon/polearm/spear/billhook,
/obj/item/clothing/head/crown/circlet/sleepless,
/obj/effect/spawner/map_spawner/loot/coin/absurd,
/obj/effect/spawner/map_spawner/loot/potion_vitals,
/turf/open/floor/dirt,
/area/rogue)
"YL" = (
/obj/structure/stairs/stone{
	dir = 1
	},
/turf/open/floor/snow,
/area/rogue)
"ZF" = (
/obj/structure/fluff/railing/wood,
/obj/structure/fluff/railing/wood{
	dir = 4
	},
/turf/open/floor/snow,
/area/rogue)

(1,1,1) = {"
CO
CO
CO
CO
CO
CO
CO
CO
CO
CO
CO
CO
CO
Xp
wX
Xp
CO
CO
CO
CO
CO
CO
CO
CO
CO
CO
CO
CO
CO
CO
"}
(2,1,1) = {"
CO
HX
wl
wl
wl
CO
CO
CO
Xp
Xp
Xp
Xp
Xp
Xp
Xp
Xp
Xp
Xp
Xp
CO
YL
fS
fS
fS
fS
wl
wl
uD
uD
CO
"}
(3,1,1) = {"
CO
uD
uD
HX
wl
wl
wl
CO
CO
Xp
Xp
pE
Xp
xC
xC
xC
xC
CO
CO
CO
YL
fS
fS
fS
aY
wl
wl
Ai
aY
CO
"}
(4,1,1) = {"
CO
wl
wl
HX
aY
wl
wl
fS
CO
CO
xC
xC
xC
fS
fS
CO
CO
CO
fS
fS
fS
fS
fS
wl
wl
aY
uD
Ai
wl
CO
"}
(5,1,1) = {"
CO
wl
aY
HX
wl
wl
fS
fS
fS
CO
CO
CO
fS
fS
CO
CO
fS
fS
fS
fS
fS
fS
fS
wl
uD
uD
Ai
wl
wl
CO
"}
(6,1,1) = {"
CO
wl
wl
HX
wl
wl
wl
wl
fS
fS
fS
fS
fS
fS
fS
fS
fS
fS
fS
fS
wl
wl
aY
wl
Ai
wl
wl
wl
CO
CO
"}
(7,1,1) = {"
CO
CO
wl
uD
uD
uD
HX
wl
aY
wl
wl
fS
Ma
OQ
kD
fS
wl
wl
wl
wl
wl
uD
uD
uD
Ai
aY
wl
Xp
Xp
CO
"}
(8,1,1) = {"
CO
CO
CO
wl
wl
wl
uD
uD
uD
HX
wl
wl
Ma
OQ
kD
wl
aY
uD
uD
uD
uD
Ai
wl
wl
wl
wl
CO
CO
Xp
CO
"}
(9,1,1) = {"
CO
Xk
CO
fS
fS
wl
wl
wl
wl
uD
uD
uD
Ma
OQ
kD
uD
uD
Ai
wl
wl
aY
wl
wl
fS
xC
xC
CO
Xp
Xp
CO
"}
(10,1,1) = {"
CO
be
CO
fS
xC
xC
xC
wl
wl
wl
wl
aY
Ma
OQ
kD
wl
wl
wl
wl
fS
fS
xC
xC
xC
xC
xC
CO
Xp
xC
CO
"}
(11,1,1) = {"
CO
bg
CO
xC
KO
KO
xC
xC
xC
fS
fS
fS
Ma
OQ
kD
fS
fS
fS
fS
xC
xC
xC
KO
KO
KO
xC
CO
xC
xC
CO
"}
(12,1,1) = {"
CO
bg
CO
xC
KO
KO
KO
KO
KO
xC
fS
fS
fS
fS
fS
fS
fS
fS
xC
xC
xC
AB
KO
dN
KO
xC
CO
xC
xC
CO
"}
(13,1,1) = {"
CO
Xp
CO
CO
xC
KO
dN
WV
KO
xC
fS
fS
fS
fS
fS
fS
fS
fS
fS
xC
KO
KO
KO
KO
xC
xC
CO
xC
xC
CO
"}
(14,1,1) = {"
bW
Xp
pE
CO
xC
KO
KO
KO
xC
fS
fS
fS
UN
UN
UN
fS
fS
fS
fS
xC
KO
KO
xC
xC
xC
CO
CO
xC
Xp
Vc
"}
(15,1,1) = {"
CO
Xp
Xp
CO
CO
xC
xC
xC
fS
fS
CO
CO
CO
CO
CO
CO
CO
CO
fS
fS
fS
fS
fS
xC
CO
CO
pE
Xp
Xp
CO
"}
(16,1,1) = {"
Aq
Xp
Xp
Xp
CO
CO
fS
fS
fS
CO
CO
tH
la
hZ
cW
RS
RS
CO
CO
CO
fS
fS
CO
CO
CO
Xp
Xp
Xp
Xp
Aq
"}
(17,1,1) = {"
CO
Xp
Xp
Xp
Xp
fS
fS
fS
fS
fS
Xp
Xp
Xp
Xp
xC
xC
xC
Xp
fS
fS
fS
fS
fS
fS
Xp
Xp
Xp
be
Xp
CO
"}
(18,1,1) = {"
CO
Xp
Xp
uB
uB
uB
uB
fS
fS
Xp
Xp
Xp
xC
xC
xC
xC
xC
xC
Xp
Xp
fS
fS
fS
Xp
Xp
Xp
iO
iO
iO
CO
"}
(19,1,1) = {"
CO
Xp
Xp
uB
wQ
Xp
uB
uB
Xp
pE
Xp
UM
TM
xC
bx
TM
Ub
xC
Xp
Xp
Xp
pE
Xp
Xp
Xp
Xp
iO
iO
Jv
CO
"}
(20,1,1) = {"
CO
Xp
Xp
uB
DL
Xp
Xp
vd
Xp
Xp
xC
TM
hS
TM
TM
rk
TM
xC
Xp
Xp
Xp
Xp
Xp
Xp
Xp
wl
iO
iO
BC
CO
"}
(21,1,1) = {"
CO
Xp
Xp
uB
rl
Xp
uB
uB
Xp
Xp
xC
xC
fA
fA
fA
fA
Xp
Xp
Xp
Xp
xm
Xp
Xp
aY
wl
wl
iO
Qs
iO
CO
"}
(22,1,1) = {"
CO
Xp
Xp
uB
uB
uB
uB
Xp
Xp
Xp
Xp
Xp
Xp
Xp
Xp
Xp
Xp
Xp
Xp
xC
xC
xC
wl
wl
wl
wl
wl
wl
wl
CO
"}
(23,1,1) = {"
CO
Xp
Xp
Xp
Xp
Xp
Xp
Xp
Xp
Xp
si
SA
SA
SA
SA
SA
SA
mX
xC
DA
xC
wl
wl
wl
wl
wl
wl
wl
wl
CO
"}
(24,1,1) = {"
CO
Xp
uB
uB
uB
uB
Xp
Xp
Xp
xC
NX
Um
Xp
yb
Xp
BB
tl
Vr
xC
xC
xC
wl
wl
wl
aY
Xp
xC
xC
wl
CO
"}
(25,1,1) = {"
CO
Xp
uB
wQ
Xp
uB
uB
Xp
xC
xC
NX
Hl
Xp
Xp
Yp
Xp
xC
Vr
xC
xC
aY
wl
wl
wl
xC
xC
Dj
xC
wl
CO
"}
(26,1,1) = {"
CO
Xp
uB
vJ
Xp
Xp
vd
Xp
xC
xC
NX
xC
Xp
aw
Xp
Wp
xC
Vr
xC
Xp
wl
wl
wl
xC
xC
mV
xC
xC
wl
CO
"}
(27,1,1) = {"
CO
Xp
uB
wQ
Xp
uB
uB
Xp
xC
xC
nC
Bg
Bg
Bg
yz
yz
yz
hR
Xp
Xp
wl
wl
aY
xC
xC
xC
Xp
wl
wl
CO
"}
(28,1,1) = {"
CO
Xp
uB
uB
uB
uB
Xp
Xp
pE
Xp
Xp
Xp
Xp
Xp
xC
xC
Xp
Xp
Xp
pE
wl
wl
wl
wl
Xp
Xp
wl
aY
wl
CO
"}
(29,1,1) = {"
CO
Xp
Xp
Xp
Xp
Xp
Xp
Xp
Xp
Xp
Xp
Xp
Xp
Xp
Xp
Xp
Xp
Xp
Xp
wl
wl
wl
wl
wl
wl
wl
wl
wl
wl
CO
"}
(30,1,1) = {"
CO
CO
CO
CO
CO
CO
CO
CO
CO
CO
CO
CO
CO
CO
Mz
CO
Aq
CO
CO
CO
CO
CO
CO
CO
CO
CO
CO
CO
CO
CO
"}

(1,1,2) = {"
CO
CO
CO
CO
CO
CO
CO
CO
CO
CO
CO
CO
CO
fS
KO
fS
fS
CO
CO
CO
CO
CO
CO
CO
CO
CO
CO
CO
CO
CO
"}
(2,1,2) = {"
CO
Jv
Jv
Jv
Jv
fS
fS
fS
fS
fS
fS
KO
KO
xC
xC
KO
fS
fS
fS
YL
Jv
Jv
Jv
Jv
Jv
Jv
Jv
Jv
Jv
CO
"}
(3,1,2) = {"
CO
Jv
Jv
Jv
Jv
Jv
Jv
fS
fS
fS
xC
xC
xC
xC
xC
xC
KO
fS
fS
YL
Jv
Jv
Jv
Jv
Jv
Jv
Jv
Jv
Jv
CO
"}
(4,1,2) = {"
CO
Jv
Jv
Jv
Jv
Jv
Jv
Jv
fS
fS
KO
fA
lu
fA
xC
KO
KO
fS
Jv
Jv
Jv
Jv
Jv
Jv
Jv
Jv
Jv
Jv
Jv
CO
"}
(5,1,2) = {"
CO
Jv
Jv
Jv
Jv
Jv
Jv
Jv
Jv
fS
KO
xC
xC
xC
xC
KO
Jv
Jv
Jv
Jv
Jv
Jv
Jv
Jv
Jv
Jv
Jv
Jv
Jv
CO
"}
(6,1,2) = {"
CO
Jv
Jv
Jv
Jv
Jv
Jv
Jv
Jv
Jv
Jv
Jv
Jv
Jv
Jv
Jv
Jv
Jv
Jv
Jv
Jv
Jv
Jv
Jv
Jv
Jv
Jv
Jv
zu
CO
"}
(7,1,2) = {"
CO
fS
Jv
Jv
Jv
Jv
Jv
Jv
Jv
Jv
Jv
Jv
Jv
Jv
Jv
Jv
Jv
Jv
Jv
Jv
Jv
Jv
Jv
Jv
Jv
Jv
Jv
fS
fS
CO
"}
(8,1,2) = {"
CO
fS
fS
Jv
Jv
Jv
Jv
Jv
Jv
Jv
Jv
Jv
Jv
Jv
Jv
Jv
Jv
Jv
Jv
Jv
Jv
Jv
Jv
Jv
Jv
Jv
fS
fS
fS
CO
"}
(9,1,2) = {"
CO
fS
fS
Jv
Jv
Jv
Jv
Jv
Jv
Jv
Jv
Jv
Jv
Jv
Jv
Jv
Jv
Jv
Jv
Jv
Jv
Jv
Jv
Jv
Jv
Jv
fS
XY
fS
CO
"}
(10,1,2) = {"
CO
zu
fS
Jv
Jv
Jv
Jv
Jv
Jv
Jv
Jv
Jv
Jv
Jv
Jv
Jv
Jv
Jv
Jv
Jv
Jv
Jv
Jv
Jv
Jv
Jv
fS
fS
fS
CO
"}
(11,1,2) = {"
CO
fS
fS
Jv
Jv
Jv
Jv
Jv
Jv
Jv
Jv
Jv
Jv
Jv
Jv
Jv
Jv
Jv
Jv
Jv
Jv
Jv
Jv
Jv
Jv
Jv
fS
fS
fS
CO
"}
(12,1,2) = {"
CO
fS
fS
Jv
Jv
Jv
Jv
Jv
Jv
Jv
Jv
Jv
Jv
Jv
Jv
Jv
Jv
Jv
Jv
Jv
Jv
Jv
Jv
Jv
Jv
Jv
fS
fS
fS
CO
"}
(13,1,2) = {"
CO
fS
fS
zu
Jv
Jv
Jv
Jv
Jv
Jv
Jv
Jv
Jv
Jv
Jv
Jv
Jv
Jv
Jv
Jv
Jv
Jv
Jv
Jv
Jv
Jv
fS
fS
fS
CO
"}
(14,1,2) = {"
KO
KO
fS
fS
Jv
Jv
Jv
Jv
Jv
Jv
Jv
Jv
Jv
Jv
Jv
Jv
Jv
Jv
Jv
Jv
Jv
Jv
Jv
Jv
Jv
fS
fS
fS
fS
fS
"}
(15,1,2) = {"
KO
KO
KO
fS
fS
Jv
Jv
Jv
Jv
Jv
fS
fS
UN
UN
UN
xC
xC
fS
Jv
Jv
Jv
Jv
Jv
Jv
fS
fS
fS
fS
fS
fS
"}
(16,1,2) = {"
fS
KO
KO
fS
fS
fS
fS
fS
fS
fS
fS
fS
xC
KO
KO
xC
fS
fS
fS
fS
fS
fS
fS
fS
fS
fS
fS
fS
fS
fS
"}
(17,1,2) = {"
CO
KO
KO
xC
xC
fS
fS
fS
xC
xC
xC
xC
xC
KO
KO
xC
fS
fS
fS
KO
KO
fS
fS
fS
fS
fS
fS
wM
wM
CO
"}
(18,1,2) = {"
CO
KO
KO
KO
KO
xC
xC
xC
xC
no
xC
xC
KO
KO
KO
xC
xC
fS
KO
KO
KO
fS
fS
fS
fS
wM
ZF
Jv
Jv
CO
"}
(19,1,2) = {"
CO
fS
KO
KO
KO
KO
xC
xC
xC
xC
xC
xC
KO
KO
xC
xC
xC
fS
KO
KO
EU
fS
fS
XY
ZF
Jv
Jv
Jv
Jv
CO
"}
(20,1,2) = {"
CO
fS
fS
xC
KO
KO
KO
KO
xC
xC
xC
KO
KO
xC
xC
no
xC
fS
fS
fS
fS
fS
wM
ZF
Jv
Jv
Jv
Jv
Jv
CO
"}
(21,1,2) = {"
CO
fS
fS
xC
xC
KO
KO
KO
KO
KO
xC
KO
KO
xC
xC
xC
xC
fS
fS
fS
wM
ZF
Jv
Jv
Jv
Jv
Jv
Jv
Jv
CO
"}
(22,1,2) = {"
CO
fS
fS
xC
xC
xC
xC
KO
KO
KO
KO
KO
KO
xC
xC
xC
xC
fS
fS
ZF
Jv
Jv
Jv
Jv
Jv
Jv
Jv
Jv
Jv
CO
"}
(23,1,2) = {"
CO
fS
fS
xC
no
xC
xC
xC
xC
KO
KO
KO
xC
mV
xC
xC
KO
KO
Sq
Jv
Jv
Jv
Jv
Jv
Jv
Jv
Jv
Jv
Jv
CO
"}
(24,1,2) = {"
CO
fS
fS
fS
xC
xC
xC
no
xC
xC
KO
KO
xC
xC
xC
xC
KO
dN
Uu
Jv
Jv
Jv
Jv
Jv
Jv
Jv
Jv
Jv
Jv
CO
"}
(25,1,2) = {"
CO
fS
fS
fS
KO
KO
xC
xC
xC
xC
KO
KO
xC
xC
xC
xC
fS
KO
NI
Jv
Jv
Jv
Jv
Jv
Jv
Jv
Jv
Jv
Jv
CO
"}
(26,1,2) = {"
CO
fS
fS
KO
KO
KO
xC
xC
xC
xC
KO
KO
xC
no
xC
xC
fS
Sq
Jv
Jv
Jv
Jv
Jv
Jv
Jv
Jv
Jv
Jv
Jv
CO
"}
(27,1,2) = {"
CO
fS
fS
KO
KO
fS
fS
fS
xC
xC
KO
KO
xC
xC
xC
fS
fS
Sq
Jv
Jv
Jv
Jv
Jv
Jv
Jv
Jv
Jv
Jv
Jv
CO
"}
(28,1,2) = {"
CO
CO
fS
fS
fS
fS
fS
fS
fS
fS
KO
KO
KO
KO
KO
KO
fS
Sq
Jv
Jv
Jv
Jv
Jv
Jv
Jv
Jv
Jv
Jv
Jv
CO
"}
(29,1,2) = {"
CO
CO
CO
fS
fS
fS
fS
fS
fS
fS
fS
KO
KO
KO
KO
KO
KO
Sq
Jv
Jv
Jv
Jv
Jv
Jv
Jv
Jv
Jv
Jv
Jv
CO
"}
(30,1,2) = {"
CO
CO
CO
CO
CO
CO
CO
CO
CO
CO
CO
CO
CO
CO
fS
KO
KO
CO
CO
CO
CO
CO
CO
CO
CO
CO
CO
CO
CO
CO
"}
