//MAP CONVERTED BY dmm2tgm.py THIS HEADER COMMENT PREVENTS RECONVERSION, DO NOT REMOVE
"aw" = (
/obj/structure/closet/crate/chest/neu,
/obj/effect/spawner/map_spawner/loot/potion_ingredient/herb,
/obj/effect/spawner/map_spawner/loot/potion_ingredient/herb,
/obj/effect/spawner/map_spawner/loot/potion_ingredient/herb,
/obj/effect/spawner/map_spawner/loot/potion_ingredient/herb,
/obj/effect/spawner/map_spawner/loot/potion_ingredient/herb,
/obj/effect/decal/cleanable/dirt/dust,
/turf/open/floor/blocks,
/area/rogue)
"aW" = (
/obj/structure/fluff/railing/wood,
/turf/open/floor/wood,
/area/rogue)
"bk" = (
/obj/structure/table/wood/nice/decorated,
/obj/item/reagent_containers/glass/carafe/silver/redwine{
	pixel_y = 11;
	pixel_x = -2
	},
/turf/open/floor/wood,
/area/rogue)
"bn" = (
/obj/machinery/light/fueled/wallfire/candle/r,
/obj/structure/bed/inn,
/obj/item/bedsheet/wool,
/turf/open/floor/carpet/royalblack,
/area/rogue)
"bo" = (
/obj/effect/decal/cobbleedge{
	dir = 1
	},
/turf/open/floor/naturalstone,
/area/rogue)
"bW" = (
/obj/machinery/light/fueled/cauldron,
/obj/effect/decal/cleanable/dirt/dust,
/turf/open/floor/blocks/green,
/area/rogue)
"ca" = (
/obj/effect/decal/cleanable/dirt/dust,
/obj/machinery/light/fueled/wallfire/candle/r,
/turf/open/floor/wood,
/area/rogue)
"eg" = (
/turf/open/transparent/openspace,
/area/rogue)
"ei" = (
/turf/open/floor/carpet/red,
/area/rogue)
"er" = (
/obj/effect/dungeon_directional_helper/north,
/turf/open/floor/dirt/road,
/area/rogue)
"fh" = (
/turf/open/floor/wood,
/area/rogue)
"fC" = (
/turf/open/floor/cobble,
/area/rogue)
"hR" = (
/obj/structure/fluff/railing/wood{
	dir = 4
	},
/obj/effect/decal/cleanable/dirt/dust,
/turf/open/floor/wood,
/area/rogue)
"iP" = (
/obj/effect/decal/cleanable/dirt/dust,
/turf/open/floor/carpet/purple,
/area/rogue)
"iW" = (
/obj/effect/dungeon_directional_helper/west,
/turf/open/floor/naturalstone,
/area/rogue)
"jf" = (
/obj/structure/fluff/railing/wood{
	dir = 4
	},
/turf/open/floor/wood,
/area/rogue)
"jq" = (
/obj/structure/fermentation_keg/random/water,
/turf/open/floor/blocks,
/area/rogue)
"kZ" = (
/obj/structure/table/stone_small,
/obj/item/reagent_containers/food/snacks/meat/fatty{
	pixel_x = -5;
	pixel_y = 3
	},
/obj/item/reagent_containers/food/snacks/fat{
	pixel_y = 13
	},
/obj/item/reagent_containers/food/snacks/truffles{
	pixel_x = -5;
	pixel_y = 5
	},
/turf/open/floor/cobble,
/area/rogue)
"mA" = (
/turf/open/floor/dirt,
/area/rogue)
"mM" = (
/obj/structure/mineral_door/wood/donjon/stone,
/turf/open/floor/herringbone,
/area/rogue)
"nh" = (
/obj/structure/roguerock,
/turf/open/floor/naturalstone,
/area/rogue)
"ni" = (
/obj/item/clothing/neck/psycross/g{
	pixel_x = -6;
	pixel_y = 0
	},
/obj/structure/table/stone_small,
/obj/item/weapon/knife/dagger/silver{
	pixel_x = 6;
	pixel_y = 5
	},
/turf/open/floor/carpet/red,
/area/rogue)
"nV" = (
/turf/open/floor/blocks/green,
/area/rogue)
"oa" = (
/obj/structure/closet/crate/crafted_closet/dark,
/obj/item/clothing/ring/silver,
/turf/open/floor/carpet/royalblack,
/area/rogue)
"or" = (
/obj/item/clothing/pants/skirt/random{
	pixel_x = 8;
	pixel_y = 9
	},
/obj/effect/decal/cleanable/vomit/old,
/turf/open/floor/carpet/royalblack,
/area/rogue)
"oF" = (
/obj/structure/mannequin,
/turf/open/floor/herringbone,
/area/rogue)
"pF" = (
/obj/machinery/light/fueled/wallfire/candle/weak/l,
/turf/open/floor/herringbone,
/area/rogue)
"pR" = (
/obj/structure/mineral_door/wood/red,
/turf/open/floor/wood/nosmooth,
/area/rogue)
"qh" = (
/turf/open/floor/herringbone,
/area/rogue)
"qk" = (
/obj/machinery/light/fueled/wallfire/candle/weak/l,
/obj/structure/mannequin/male/female,
/turf/open/floor/herringbone,
/area/rogue)
"rx" = (
/obj/structure/stairs/stone{
	dir = 1;
	icon_state = "stonestairs"
	},
/obj/structure/fluff/railing/wood{
	dir = 4;
	pixel_y = 8
	},
/turf/open/floor/cobble,
/area/rogue)
"tc" = (
/turf/open/floor/carpet/purple,
/area/rogue)
"ti" = (
/obj/machinery/light/fueled/torchholder/l,
/obj/effect/decal/cleanable/dirt/dust,
/obj/effect/decal/cleanable/dirt/dust,
/turf/open/floor/blocks,
/area/rogue)
"uS" = (
/obj/effect/decal/shadow_floor{
	dir = 4
	},
/obj/structure/fluff/railing/wood{
	dir = 4;
	pixel_y = 8
	},
/turf/open/floor/cobble,
/area/rogue)
"vw" = (
/obj/effect/decal/shadow_floor{
	dir = 1
	},
/obj/effect/decal/cleanable/dirt/dust,
/turf/open/floor/cobble,
/area/rogue)
"vK" = (
/turf/closed/wall/mineral/decostone/cand,
/area/rogue)
"vM" = (
/obj/structure/mannequin/male,
/turf/open/floor/herringbone,
/area/rogue)
"vR" = (
/obj/item/clothing/gloves/leather{
	pixel_x = -7;
	pixel_y = -9
	},
/obj/effect/decal/cleanable/vomit/old,
/turf/open/floor/carpet/royalblack,
/area/rogue)
"xz" = (
/obj/effect/decal/cleanable/dirt/dust,
/turf/open/floor/blocks/green,
/area/rogue)
"yq" = (
/obj/effect/decal/cobbleedge{
	dir = 6
	},
/turf/open/floor/naturalstone,
/area/rogue)
"yJ" = (
/obj/structure/table/stone_small,
/obj/item/pestle,
/obj/effect/decal/cleanable/dirt/dust,
/turf/open/floor/cobble,
/area/rogue)
"yW" = (
/obj/structure/table/wood/treestump/shroomstump,
/turf/open/floor/dirt/road,
/area/rogue)
"zb" = (
/obj/structure/rack/shelf/big{
	pixel_y = 0
	},
/obj/item/reagent_containers/glass/bucket/wooden{
	pixel_x = 5
	},
/obj/item/natural/cloth{
	pixel_x = -4;
	pixel_y = 5
	},
/obj/effect/decal/cleanable/dirt/dust,
/turf/open/floor/blocks,
/area/rogue)
"zc" = (
/obj/effect/decal/shadow_floor,
/obj/effect/decal/cleanable/dirt/dust,
/turf/open/floor/blocks,
/area/rogue)
"zG" = (
/turf/open/floor/cobblerock,
/area/rogue)
"AC" = (
/obj/structure/trap/wall_projectile{
	dir = 4
	},
/turf/open/floor/naturalstone,
/area/rogue)
"BU" = (
/obj/structure/mineral_door/wood/deadbolt{
	dir = 1;
	locked = 1
	},
/obj/effect/decal/shadow_floor,
/turf/open/floor/blocks,
/area/rogue)
"CH" = (
/obj/structure/table/stone_small,
/obj/item/mortar{
	pixel_y = 9
	},
/turf/open/floor/cobble,
/area/rogue)
"CJ" = (
/obj/machinery/light/fueled/lanternpost{
	dir = 1
	},
/turf/open/floor/cobble,
/area/rogue)
"CP" = (
/obj/structure/fluff/walldeco/painting/skull{
	pixel_x = -32
	},
/obj/effect/decal/cleanable/dirt/dust,
/turf/open/floor/wood,
/area/rogue)
"CT" = (
/obj/effect/decal/cobbleedge{
	dir = 9
	},
/turf/open/floor/naturalstone,
/area/rogue)
"DK" = (
/mob/living/simple_animal/hostile/retaliate/trufflepig,
/obj/item/clothing/shirt/undershirt/fancy{
	pixel_x = 10;
	pixel_y = 6
	},
/turf/open/floor/carpet/royalblack,
/area/rogue)
"Fc" = (
/obj/effect/decal/cobbleedge,
/turf/open/floor/naturalstone,
/area/rogue)
"Gf" = (
/obj/structure/table/wood/reinforced_alter,
/obj/structure/bars/bent,
/obj/effect/decal/shadow_floor,
/turf/open/floor/blocks,
/area/rogue)
"GK" = (
/obj/structure/mineral_door/wood/deadbolt{
	dir = 1
	},
/turf/open/floor/blocks,
/area/rogue)
"Ha" = (
/obj/structure/roguerock,
/turf/open/floor/cobblerock,
/area/rogue)
"HT" = (
/turf/closed/wall/mineral/stone,
/area/rogue)
"In" = (
/obj/structure/closet/crate/chest/neu,
/obj/item/alch/firedust,
/obj/item/alch/magicdust,
/obj/item/alch/earthdust,
/obj/item/alch/coaldust,
/obj/item/alch/coaldust,
/obj/effect/decal/cleanable/dirt/dust,
/turf/open/floor/blocks,
/area/rogue)
"JG" = (
/obj/structure/flora/grass/herb/random,
/turf/open/floor/dirt,
/area/rogue)
"Kw" = (
/obj/structure/mineral_door/wood/red,
/turf/open/floor/blocks,
/area/rogue)
"KE" = (
/obj/effect/decal/remains/human,
/obj/item/reagent_containers/glass/bottle{
	pixel_x = -6;
	pixel_y = -6;
	closed = 0
	},
/turf/open/floor/carpet/royalblack,
/area/rogue)
"KR" = (
/obj/structure/trap/bomb,
/turf/open/floor/carpet/red,
/area/rogue)
"Lb" = (
/obj/machinery/light/fueled/torchholder/l,
/obj/effect/decal/cleanable/dirt/dust,
/turf/open/floor/blocks,
/area/rogue)
"MX" = (
/obj/effect/decal/shadow_floor{
	dir = 5
	},
/obj/effect/decal/cleanable/dirt/dust,
/turf/open/floor/cobble,
/area/rogue)
"NE" = (
/obj/effect/decal/cleanable/dirt/dust,
/turf/open/floor/cobble,
/area/rogue)
"NO" = (
/obj/structure/stairs/stone,
/turf/open/floor/cobble,
/area/rogue)
"Pt" = (
/obj/machinery/light/fueled/torchholder/r,
/turf/open/floor/cobble,
/area/rogue)
"Qz" = (
/turf/closed/wall/mineral/decostone/center,
/area/rogue)
"Re" = (
/obj/structure/rack,
/obj/item/cooking/pan,
/turf/open/floor/wood,
/area/rogue)
"Sa" = (
/turf/open/water/swamp,
/area/rogue)
"Se" = (
/turf/open/floor/dirt/road,
/area/rogue)
"Sf" = (
/obj/machinery/light/fueled/torchholder/l,
/obj/effect/decal/cleanable/dirt/dust,
/turf/open/floor/cobble,
/area/rogue)
"Sk" = (
/turf/open/floor/naturalstone,
/area/rogue)
"SS" = (
/obj/structure/table/wood/treestump/shroomstump,
/turf/open/floor/dirt,
/area/rogue)
"TU" = (
/obj/item/candle/yellow,
/obj/structure/table/wood/plain/alt,
/turf/open/floor/wood,
/area/rogue)
"Vk" = (
/obj/effect/decal/cleanable/dirt/dust,
/turf/open/floor/blocks,
/area/rogue)
"Vo" = (
/turf/closed/wall/mineral/craftstone,
/area/rogue)
"VF" = (
/obj/machinery/light/fueled/hearth/big_fireplace{
	pixel_x = -32
	},
/turf/closed/wall/mineral/stone,
/area/rogue)
"VH" = (
/obj/effect/decal/cobbleedge{
	dir = 10
	},
/turf/open/floor/naturalstone,
/area/rogue)
"WQ" = (
/turf/closed/wall/mineral/decostone,
/area/rogue)
"Xe" = (
/turf/closed/mineral/bedrock,
/area/rogue)
"XH" = (
/obj/effect/decal/cleanable/dirt/dust,
/turf/open/floor/wood,
/area/rogue)
"XM" = (
/obj/effect/dungeon_directional_helper/east,
/turf/open/floor/naturalstone,
/area/rogue)
"Yq" = (
/obj/effect/decal/cobbleedge{
	dir = 8
	},
/turf/open/floor/naturalstone,
/area/rogue)
"Za" = (
/obj/structure/stairs/stone,
/obj/machinery/light/fueled/wallfire/candle/r,
/turf/open/floor/cobble,
/area/rogue)
"ZV" = (
/turf/open/floor/blocks,
/area/rogue)

(1,1,1) = {"
Xe
Xe
Xe
Xe
Xe
Xe
Xe
Xe
mA
Se
Se
Se
Sk
iW
Sk
Sk
Sk
Xe
Xe
Xe
"}
(2,1,1) = {"
Xe
Xe
Xe
Xe
Xe
Xe
Xe
JG
mA
Se
Se
Sk
Sk
Sk
Sk
Sk
Xe
Xe
Xe
Xe
"}
(3,1,1) = {"
Xe
Xe
Xe
Xe
Xe
Xe
Xe
Xe
Xe
mA
Se
Sk
nh
Sk
Sk
Sk
Xe
Xe
Xe
Xe
"}
(4,1,1) = {"
Xe
Xe
Xe
Xe
Xe
Xe
Xe
Xe
Xe
mA
Sk
Sk
Sk
Sk
Sk
Sk
Xe
Xe
Xe
Xe
"}
(5,1,1) = {"
Xe
Xe
Xe
Xe
Xe
Xe
Xe
Xe
Sk
Sk
Sk
Sk
Xe
Sk
Sk
Xe
Xe
Xe
Xe
Xe
"}
(6,1,1) = {"
Xe
Xe
Xe
Xe
Xe
Xe
Xe
Se
Sk
Sk
nh
Sk
Xe
Sk
Sk
Xe
Xe
Xe
Xe
Xe
"}
(7,1,1) = {"
Xe
Xe
JG
Xe
Xe
Xe
mA
Se
Se
Sk
Sk
Sk
Sk
Sk
mA
Xe
zG
zG
Ha
Xe
"}
(8,1,1) = {"
Xe
Xe
mA
Xe
Se
Se
Se
Se
Xe
Sk
Sk
Sk
Sk
Sk
mA
Xe
Xe
zG
zG
Xe
"}
(9,1,1) = {"
Se
Se
Se
Se
Se
Se
Sk
Se
Sk
Sk
Sk
Sk
Sk
mA
Se
Xe
Xe
zG
Xe
Xe
"}
(10,1,1) = {"
er
Se
Se
Se
Se
Se
Sk
Sk
Sk
Sk
Sk
Sk
Sk
Se
Se
Xe
zG
zG
Xe
Xe
"}
(11,1,1) = {"
Se
Sk
Sk
Sk
Sk
Sk
Sk
CT
Yq
VH
Sk
Sk
Sk
Se
Se
mA
Se
Xe
Xe
Xe
"}
(12,1,1) = {"
HT
HT
HT
HT
HT
Sk
Sk
bo
CJ
Fc
Sk
Sk
Se
Se
Xe
mA
Xe
Xe
Xe
Xe
"}
(13,1,1) = {"
HT
CH
yJ
Sf
HT
HT
HT
HT
HT
yq
Sk
Sk
Se
Xe
Xe
mA
mA
Xe
Xe
Xe
"}
(14,1,1) = {"
HT
xz
xz
fC
Gf
ZV
Lb
ZV
HT
Sk
Sk
Sk
Se
Xe
Sa
mA
JG
Xe
Xe
Xe
"}
(15,1,1) = {"
HT
bW
nV
fC
BU
Vk
ZV
ZV
GK
Sk
Sk
Sk
Se
Xe
Xe
Xe
Xe
Xe
Xe
Xe
"}
(16,1,1) = {"
HT
nV
nV
NE
HT
HT
HT
HT
HT
Sk
Sk
Sk
Sk
Se
Xe
Xe
Xe
Xe
Xe
Xe
"}
(17,1,1) = {"
HT
kZ
NE
NE
zc
HT
ti
In
HT
Sk
Sk
Sk
Sk
Sk
Xe
Xe
Xe
Xe
Xe
Xe
"}
(18,1,1) = {"
HT
fC
NE
Pt
zc
Kw
Vk
aw
HT
Sk
Sk
Sk
Sk
Sk
mA
Xe
Xe
Xe
Xe
Xe
"}
(19,1,1) = {"
HT
fC
NO
HT
jq
HT
Vk
zb
HT
Sk
Sk
Sk
Sk
Sk
Xe
Xe
Xe
Xe
Xe
Xe
"}
(20,1,1) = {"
HT
HT
HT
HT
HT
HT
HT
HT
HT
Sk
Sk
XM
Sk
Sk
Xe
Xe
Xe
Xe
Xe
Xe
"}

(1,1,2) = {"
Xe
Xe
Xe
Xe
Xe
Xe
Xe
Xe
Xe
zG
zG
Sk
Sk
eg
eg
eg
eg
Xe
Xe
Xe
"}
(2,1,2) = {"
Xe
Xe
Xe
Xe
JG
Xe
Xe
Xe
Xe
Xe
zG
Sk
Sk
eg
eg
eg
Xe
Xe
Xe
Xe
"}
(3,1,2) = {"
Xe
Xe
Xe
Xe
SS
mA
Ha
Xe
Xe
Xe
Ha
Sk
Sk
Sk
eg
eg
Xe
Xe
Xe
Xe
"}
(4,1,2) = {"
Xe
Xe
Xe
Xe
mA
yW
zG
Xe
Xe
Xe
Xe
Sk
zG
Sk
nh
eg
Xe
Xe
Xe
Xe
"}
(5,1,2) = {"
Xe
Xe
Xe
Xe
Se
Se
Se
Xe
Xe
Xe
Xe
zG
Ha
zG
Sk
Xe
Xe
Xe
Xe
Xe
"}
(6,1,2) = {"
Xe
Xe
Xe
Xe
Se
Sk
Se
Se
Xe
Xe
Xe
zG
zG
Sk
Sk
Xe
Xe
Xe
Xe
Xe
"}
(7,1,2) = {"
Xe
Xe
Xe
Xe
Sk
Xe
Xe
Se
Sk
eg
Xe
Sk
Ha
Sk
Sk
Sk
eg
eg
eg
Xe
"}
(8,1,2) = {"
Xe
Sk
Sk
Xe
eg
Xe
Xe
Sk
Sk
eg
eg
Sk
Sk
Xe
Xe
Xe
Xe
eg
eg
Xe
"}
(9,1,2) = {"
Sk
Sk
Sk
eg
eg
eg
Xe
Sk
eg
eg
eg
eg
Sk
Xe
Xe
Xe
Xe
Xe
Xe
Xe
"}
(10,1,2) = {"
Sk
Sk
Sk
Sk
eg
eg
Sk
Sk
eg
eg
eg
eg
eg
eg
Xe
Xe
WQ
Qz
WQ
Xe
"}
(11,1,2) = {"
Sk
Sk
Sk
eg
eg
eg
eg
eg
eg
eg
eg
eg
Xe
Xe
Xe
WQ
vK
ni
vK
WQ
"}
(12,1,2) = {"
HT
HT
HT
HT
HT
eg
eg
eg
eg
eg
eg
eg
Xe
Xe
Xe
WQ
qk
ei
pF
WQ
"}
(13,1,2) = {"
HT
HT
XH
TU
HT
HT
HT
HT
HT
eg
eg
eg
Xe
Xe
Xe
WQ
qh
KR
oF
WQ
"}
(14,1,2) = {"
HT
VF
XH
XH
XH
XH
CP
bk
HT
eg
eg
eg
eg
Xe
Xe
WQ
vM
ei
qh
WQ
"}
(15,1,2) = {"
HT
Re
XH
tc
XH
ca
fh
XH
HT
eg
eg
eg
eg
Xe
Xe
WQ
WQ
mM
WQ
WQ
"}
(16,1,2) = {"
HT
XH
fh
iP
XH
Vo
Vo
pR
HT
eg
eg
eg
eg
eg
Xe
Xe
Sk
AC
Sk
Xe
"}
(17,1,2) = {"
HT
fh
hR
jf
jf
Vo
oa
or
HT
eg
eg
eg
eg
eg
Xe
Xe
Xe
Sk
Xe
Xe
"}
(18,1,2) = {"
HT
fh
rx
uS
MX
Vo
DK
KE
HT
eg
eg
eg
eg
eg
eg
Sk
Sk
Sk
Xe
Xe
"}
(19,1,2) = {"
HT
aW
eg
Za
vw
Vo
vR
bn
HT
eg
eg
eg
eg
eg
Xe
Xe
Xe
Sk
Xe
Xe
"}
(20,1,2) = {"
HT
HT
HT
HT
HT
HT
HT
HT
HT
eg
eg
eg
eg
eg
Xe
Xe
Xe
HT
Xe
Xe
"}
