//MAP CONVERTED BY dmm2tgm.py THIS HEADER COMMENT PREVENTS RECONVERSION, DO NOT REMOVE
"ah" = (
/obj/item/flashlight/flare/torch/metal,
/turf/open/floor/naturalstone,
/area/rogue/under/cave)
"az" = (
/obj/structure/closet/dirthole/closed,
/mob/living/carbon/human/species/skeleton/npc/ambush,
/obj/effect/spawner/map_spawner/loot/rare,
/turf/open/floor/dirt,
/area/rogue/under/cave)
"aG" = (
/obj/item/natural/rock,
/turf/open/floor/naturalstone,
/area/rogue/under/cave)
"aH" = (
/turf/open/floor/naturalstone,
/area/rogue/under/cave)
"aX" = (
/turf/open/transparent/openspace,
/area/rogue/under/cave)
"bd" = (
/obj/structure/chair/stool,
/mob/living/carbon/human/species/rousman/npc{
	name = "Spoon Sharpener"
	},
/obj/effect/mapping_helpers/floor_clothing_equipper,
/obj/item/kitchen/spoon/iron,
/obj/item/kitchen/spoon/iron,
/turf/open/floor/naturalstone,
/area/rogue/under/cave)
"bo" = (
/obj/structure/pillory/double,
/turf/open/floor/naturalstone,
/area/rogue/under/cave)
"cc" = (
/obj/structure/closet/dirthole/grave,
/obj/item/weapon/shovel,
/turf/open/floor/dirt/road,
/area/rogue/under/cave)
"dr" = (
/obj/item/natural/stone,
/turf/open/floor/naturalstone,
/area/rogue/under/cave)
"dE" = (
/obj/structure/closet/dirthole/closed,
/mob/living/carbon/human/species/skeleton/npc/no_equipment,
/obj/effect/spawner/map_spawner/loot/weapon,
/obj/effect/mapping_helpers/floor_clothing_equipper,
/obj/effect/spawner/map_spawner/loot/armor,
/turf/open/floor/dirt,
/area/rogue/under/cave)
"ew" = (
/obj/structure/closet/dirthole/closed,
/obj/item/clothing/neck/gorget/copper,
/obj/item/clothing/head/helmet/coppercap,
/mob/living/carbon/human/species/skeleton/npc/ambush,
/turf/open/floor/dirt,
/area/rogue/under/cave)
"eK" = (
/obj/item/natural/stone{
	pixel_x = 2;
	pixel_y = -8
	},
/turf/open/floor/naturalstone,
/area/rogue/under/cave)
"eL" = (
/obj/effect/spawner/map_spawner/beartrap,
/turf/open/floor/naturalstone,
/area/rogue/under/cave)
"fm" = (
/obj/item/natural/rock/random,
/turf/open/floor/dirt/road,
/area/rogue/under/cave)
"fy" = (
/obj/structure/closet/dirthole,
/turf/open/floor/dirt/road,
/area/rogue/under/cave)
"gp" = (
/obj/item/weapon/shovel,
/turf/open/floor/dirt,
/area/rogue/under/cave)
"gT" = (
/obj/item/natural/rock/gold,
/turf/open/floor/cobblerock,
/area/rogue/under/cave)
"hQ" = (
/obj/structure/flora/grass/bush_meagre,
/turf/open/floor/grass/yel,
/area/rogue/under/cave)
"hY" = (
/obj/structure/closet/dirthole/closed,
/obj/effect/spawner/map_spawner/loot/armor,
/mob/living/carbon/human/species/skeleton/npc/ambush,
/obj/structure/closet/burial_shroud,
/turf/open/floor/dirt/road,
/area/rogue/under/cave)
"if" = (
/obj/structure/closet/dirthole/closed,
/obj/structure/closet/burial_shroud,
/mob/living/carbon/human/species/skeleton/npc/ambush,
/obj/effect/spawner/map_spawner/loot/weapon,
/turf/open/floor/dirt,
/area/rogue/under/cave)
"in" = (
/turf/open/floor/dirt,
/area/rogue/under/cave)
"iv" = (
/obj/structure/closet/dirthole/grave,
/obj/structure/closet/crate/coffin,
/obj/item/organ/guts,
/obj/item/organ/lungs,
/obj/item/organ/heart,
/obj/item/organ/tongue,
/obj/item/organ/brain,
/turf/open/floor/dirt,
/area/rogue/under/cave)
"iL" = (
/obj/structure/flora/grass/maneater,
/turf/open/floor/dirt/road,
/area/rogue/under/cave)
"iR" = (
/turf/closed/mineral/bedrock,
/area/rogue/under/cave)
"jc" = (
/obj/effect/dungeon_directional_helper/east,
/turf/open/floor/grass/yel,
/area/rogue/under/cave)
"kh" = (
/obj/structure/roguerock,
/turf/open/floor/dirt,
/area/rogue/under/cave)
"lA" = (
/obj/structure/closet/dirthole/grave,
/turf/open/floor/dirt,
/area/rogue/under/cave)
"mj" = (
/obj/structure/closet/dirthole/closed,
/obj/effect/spawner/map_spawner/loot/common,
/obj/structure/closet/burial_shroud,
/obj/item/weapon/sword/coppermesser,
/mob/living/carbon/human/species/skeleton/npc/ambush,
/turf/open/floor/dirt,
/area/rogue/under/cave)
"mu" = (
/obj/structure/roguerock,
/turf/open/floor/naturalstone,
/area/rogue/under/cave)
"mJ" = (
/obj/structure/flora/grass/herb/atropa,
/turf/open/floor/grass/yel,
/area/rogue/under/cave)
"mN" = (
/obj/item/natural/stone{
	pixel_x = 9;
	pixel_y = 5
	},
/turf/open/floor/cobblerock,
/area/rogue/under/cave)
"oB" = (
/obj/structure/stairs/stone{
	dir = 1
	},
/turf/open/floor/herringbone,
/area/rogue/under/cave)
"oM" = (
/mob/living/carbon/human/species/skeleton/npc/warrior/skilled,
/obj/effect/spawner/map_spawner/loot/rare,
/obj/structure/closet/dirthole/closed,
/obj/item/clothing/head/peaceflower{
	pixel_y = -10;
	pixel_x = -8
	},
/obj/item/reagent_containers/food/snacks/produce/poppy{
	pixel_x = 9
	},
/turf/open/floor/dirt,
/area/rogue/under/cave)
"pr" = (
/turf/open/floor/herringbone,
/area/rogue/under/cave)
"qA" = (
/obj/structure/fluff/clodpile,
/turf/open/floor/dirt,
/area/rogue/under/cave)
"rp" = (
/turf/closed/wall/mineral/decostone/end{
	dir = 8
	},
/area/rogue/under/cave)
"rr" = (
/obj/structure/closet/dirthole/closed,
/obj/item/clothing/armor/cuirass/copperchest,
/turf/open/floor/dirt,
/area/rogue/under/cave)
"rU" = (
/obj/structure/closet/dirthole/closed,
/obj/item/weapon/shield/tower,
/obj/item/weapon/mace/copperbludgeon,
/obj/effect/mapping_helpers/floor_clothing_equipper,
/mob/living/carbon/human/species/skeleton/npc/no_equipment,
/turf/open/floor/dirt,
/area/rogue/under/cave)
"si" = (
/obj/structure/flora/ausbushes/reedbush,
/turf/open/water/swamp,
/area/rogue/under/cave)
"sF" = (
/obj/structure/closet/dirthole/closed,
/obj/item/weapon/mace/spiked,
/turf/open/floor/dirt,
/area/rogue/under/cave)
"tc" = (
/turf/closed/wall/mineral/decostone/end{
	dir = 4
	},
/area/rogue/under/cave)
"tW" = (
/obj/item/natural/stone{
	pixel_x = -3;
	pixel_y = 5
	},
/turf/open/floor/naturalstone,
/area/rogue/under/cave)
"vd" = (
/obj/effect/decal/cleanable/blood/splatter,
/turf/open/floor/naturalstone,
/area/rogue/under/cave)
"vg" = (
/turf/open/floor/cobblerock,
/area/rogue/under/cave)
"vl" = (
/obj/structure/kneestingers,
/turf/open/water/swamp,
/area/rogue/under/cave)
"vH" = (
/obj/effect/dungeon_directional_helper/north,
/turf/open/floor/dirt/road,
/area/rogue/under/cave)
"wj" = (
/obj/structure/kneestingers{
	icon_state = "glowshroom2"
	},
/turf/open/water/swamp,
/area/rogue/under/cave)
"wu" = (
/obj/structure/closet/dirthole/closed,
/mob/living/carbon/human/species/skeleton/npc/ambush,
/turf/open/floor/dirt,
/area/rogue/under/cave)
"xc" = (
/obj/structure/roguerock,
/turf/open/floor/dirt/road,
/area/rogue/under/cave)
"xy" = (
/obj/structure/closet/dirthole/closed,
/obj/effect/spawner/map_spawner/loot/common,
/mob/living/carbon/human/species/skeleton/npc/warrior,
/turf/open/floor/dirt/road,
/area/rogue/under/cave)
"xP" = (
/obj/structure/gravemarker,
/obj/structure/closet/dirthole/closed/loot,
/turf/open/floor/dirt,
/area/rogue/under/cave)
"yG" = (
/obj/structure/closet/dirthole/closed,
/mob/living/carbon/human/species/skeleton/npc/warrior/skilled,
/obj/effect/spawner/map_spawner/loot/armor,
/turf/open/floor/dirt,
/area/rogue/under/cave)
"yN" = (
/turf/closed/mineral,
/area/rogue/under/cave)
"zU" = (
/obj/item/natural/stone{
	pixel_x = -6;
	pixel_y = -7
	},
/obj/item/natural/stone{
	pixel_x = 9;
	pixel_y = 5
	},
/turf/open/floor/naturalstone,
/area/rogue/under/cave)
"AF" = (
/obj/item/grown/log/tree/small,
/turf/closed/mineral/bedrock,
/area/rogue/under/cave)
"AG" = (
/obj/structure/gravemarker,
/obj/structure/closet/dirthole/closed/loot,
/turf/open/floor/dirt/road,
/area/rogue/under/cave)
"AQ" = (
/obj/item/restraints/legcuffs/beartrap/armed/camouflage,
/turf/open/floor/naturalstone,
/area/rogue/under/cave)
"Bh" = (
/obj/structure/kneestingers{
	icon_state = "glowshroom_A3"
	},
/turf/open/floor/dirt,
/area/rogue/under/cave)
"BF" = (
/obj/structure/roguerock,
/turf/open/floor/cobblerock,
/area/rogue/under/cave)
"Cj" = (
/obj/item/ingot/gold,
/obj/item/ingot/gold{
	pixel_x = 8;
	pixel_y = -4
	},
/obj/item/ingot/gold{
	pixel_x = 4;
	pixel_y = 3
	},
/turf/open/water/swamp/deep,
/area/rogue/under/cave)
"Co" = (
/obj/effect/decal/cleanable/blood/old,
/turf/open/floor/naturalstone,
/area/rogue/under/cave)
"Cq" = (
/obj/item/natural/rock,
/turf/open/floor/cobblerock,
/area/rogue/under/cave)
"CI" = (
/obj/structure/kneestingers,
/turf/open/floor/dirt,
/area/rogue/under/cave)
"CZ" = (
/obj/structure/closet/dirthole/closed,
/turf/open/floor/dirt,
/area/rogue/under/cave)
"Dz" = (
/obj/effect/decal/cleanable/blood/splatter,
/turf/open/floor/cobblerock,
/area/rogue/under/cave)
"DA" = (
/obj/structure/closet/dirthole/grave,
/obj/structure/closet/burial_shroud,
/obj/item/weapon/shield/wood,
/turf/open/floor/dirt/road,
/area/rogue/under/cave)
"DH" = (
/obj/item/natural/stone{
	pixel_x = 6;
	pixel_y = -5
	},
/obj/item/natural/stone{
	pixel_x = -3;
	pixel_y = 7
	},
/turf/open/floor/naturalstone,
/area/rogue/under/cave)
"Ei" = (
/obj/item/kitchen/spoon/iron{
	pixel_y = 3;
	pixel_x = 7
	},
/obj/item/kitchen/spoon/iron{
	pixel_x = -1;
	pixel_y = 4
	},
/obj/item/kitchen/spoon/iron{
	pixel_x = -3;
	pixel_y = -1
	},
/obj/item/kitchen/spoon/iron{
	pixel_x = 3
	},
/obj/item/kitchen/spoon/iron{
	pixel_x = -8;
	pixel_y = 3
	},
/turf/open/floor/naturalstone,
/area/rogue/under/cave)
"Eq" = (
/obj/item/natural/stone{
	pixel_x = 9;
	pixel_y = 5
	},
/obj/item/natural/stone{
	pixel_x = -6;
	pixel_y = -7
	},
/turf/open/floor/naturalstone,
/area/rogue/under/cave)
"EE" = (
/obj/item/natural/dirtclod,
/turf/open/floor/dirt,
/area/rogue/under/cave)
"EP" = (
/mob/living/carbon/human/species/skeleton/npc/ambush,
/turf/open/water/swamp/deep,
/area/rogue/under/cave)
"Ft" = (
/mob/living/carbon/human/species/skeleton/npc/ambush,
/turf/open/floor/dirt/road,
/area/rogue/under/cave)
"Fy" = (
/obj/structure/kneestingers{
	icon_state = "glowshroom_A1"
	},
/turf/open/floor/dirt,
/area/rogue/under/cave)
"GC" = (
/turf/open/water/swamp/deep,
/area/rogue/under/cave)
"GJ" = (
/obj/effect/dungeon_directional_helper/west,
/turf/open/floor/dirt/road,
/area/rogue/under/cave)
"Hc" = (
/mob/living/carbon/human/species/skeleton/npc/no_equipment,
/obj/effect/mapping_helpers/floor_clothing_equipper,
/obj/item/weapon/shovel,
/obj/item/clothing/pants/trou/leather/mourning,
/obj/item/clothing/shirt/robe/necra,
/obj/item/clothing/head/padded/deathshroud,
/obj/item/clothing/neck/psycross/silver/necra,
/turf/open/floor/dirt/road,
/area/rogue/under/cave)
"IB" = (
/obj/item/natural/rock/random,
/turf/open/floor/naturalstone,
/area/rogue/under/cave)
"IP" = (
/obj/machinery/light/fueled/firebowl/standing/blue,
/turf/open/floor/dirt/road,
/area/rogue/under/cave)
"Lx" = (
/obj/structure/closet/dirthole/grave,
/turf/open/floor/dirt/road,
/area/rogue/under/cave)
"Ly" = (
/obj/structure/closet/dirthole/grave,
/obj/structure/closet/burial_shroud,
/mob/living/carbon/human/species/skeleton/npc/no_equipment,
/turf/open/floor/dirt,
/area/rogue/under/cave)
"MV" = (
/obj/effect/decal/cleanable/blood/old,
/obj/effect/spawner/map_spawner/beartrap,
/turf/open/floor/naturalstone,
/area/rogue/under/cave)
"MX" = (
/obj/structure/grindwheel,
/turf/open/floor/naturalstone,
/area/rogue/under/cave)
"Nq" = (
/turf/open/water/swamp,
/area/rogue/under/cave)
"Nr" = (
/obj/machinery/light/fueled/torchholder/r,
/turf/open/floor/naturalstone,
/area/rogue/under/cave)
"NC" = (
/turf/open/floor/grass/yel,
/area/rogue/under/cave)
"Oh" = (
/obj/item/natural/rock/gemerald,
/turf/open/floor/cobblerock,
/area/rogue/under/cave)
"OL" = (
/obj/structure/kneestingers{
	icon_state = "glowshroom_A2"
	},
/turf/open/floor/dirt,
/area/rogue/under/cave)
"OW" = (
/obj/structure/closet/dirthole/closed,
/mob/living/carbon/human/species/skeleton/npc/ambush,
/turf/open/floor/dirt/road,
/area/rogue/under/cave)
"Pt" = (
/obj/effect/spawner/map_spawner/beartrap,
/turf/open/floor/cobblerock,
/area/rogue/under/cave)
"PD" = (
/obj/item/clothing/cloak/raincloak/mortus,
/turf/open/floor/dirt/road,
/area/rogue/under/cave)
"Qk" = (
/obj/structure/closet/dirthole/closed,
/obj/effect/landmark/chest_or_mimic,
/obj/item/gem,
/turf/open/floor/dirt,
/area/rogue/under/cave)
"QX" = (
/obj/item/clothing/head/jester,
/obj/item/clothing/shoes/jester,
/obj/item/clothing/shirt/jester,
/obj/item/clothing/pants/tights/jester,
/obj/effect/mapping_helpers/floor_clothing_equipper,
/obj/item/handheld_bell,
/mob/living/carbon/human/species/skeleton/npc/no_equipment,
/obj/item/kitchen/fork/iron,
/turf/open/floor/naturalstone,
/area/rogue/under/cave)
"Rk" = (
/obj/structure/closet/dirthole/closed,
/obj/item/weapon/shield/wood,
/turf/open/floor/dirt/road,
/area/rogue/under/cave)
"Sk" = (
/obj/structure/stairs/stone,
/turf/open/floor/herringbone,
/area/rogue/under/cave)
"SP" = (
/obj/structure/kneestingers{
	icon_state = "glowshroom2"
	},
/turf/open/floor/dirt,
/area/rogue/under/cave)
"SY" = (
/obj/effect/dungeon_directional_helper/south,
/turf/open/floor/dirt/road,
/area/rogue/under/cave)
"Vc" = (
/obj/structure/flora/grass/bush,
/turf/open/floor/grass/yel,
/area/rogue/under/cave)
"Wk" = (
/mob/living/carbon/human/species/skeleton/npc/no_equipment,
/obj/item/weapon/shovel,
/obj/item/clothing/head/padded/deathshroud,
/obj/effect/mapping_helpers/floor_clothing_equipper,
/obj/item/clothing/pants/trou/leather/mourning,
/obj/item/clothing/shirt/robe/necra,
/turf/open/floor/dirt/road,
/area/rogue/under/cave)
"WI" = (
/obj/structure/kneestingers{
	icon_state = "glowshroom3"
	},
/turf/open/water/swamp,
/area/rogue/under/cave)
"Xc" = (
/obj/item/grown/log/tree/small,
/turf/open/floor/naturalstone,
/area/rogue/under/cave)
"XK" = (
/turf/open/floor/dirt/road,
/area/rogue/under/cave)
"XO" = (
/obj/structure/flora/shroom_tree,
/turf/open/water/swamp,
/area/rogue/under/cave)
"XV" = (
/obj/item/natural/dirtclod,
/turf/open/floor/dirt/road,
/area/rogue/under/cave)
"XW" = (
/turf/closed/wall/mineral/decostone,
/area/rogue/under/cave)
"Yg" = (
/obj/structure/closet/dirthole/closed,
/turf/open/floor/dirt/road,
/area/rogue/under/cave)

(1,1,1) = {"
iR
iR
iR
iR
iR
iR
iR
iR
iR
iR
iR
iR
XK
XK
GJ
XK
iR
iR
iR
iR
iR
iR
iR
iR
iR
iR
iR
iR
iR
iR
"}
(2,1,1) = {"
iR
iR
iR
iR
iR
iR
iR
iR
iR
iR
in
in
XK
XK
XK
XK
XK
XK
aH
iR
iR
iR
iR
iR
iR
iR
iR
iR
iR
iR
"}
(3,1,1) = {"
iR
iR
iR
iR
iR
iR
iR
iR
iR
iR
iR
Nq
Nq
in
XK
XK
in
aH
iR
iR
iR
iR
CI
Nq
iR
iR
iR
iR
iR
iR
"}
(4,1,1) = {"
iR
iR
iR
iR
iR
iR
iR
iR
iR
iR
iR
iR
iR
Nq
in
XK
XK
Nq
Nq
in
iR
in
aH
XK
iR
iR
iR
iR
iR
iR
"}
(5,1,1) = {"
iR
iR
iR
iR
iR
iR
iR
iR
iR
iR
iR
iR
iR
in
in
in
Nq
Nq
XO
Nq
Nq
aH
aH
XW
iR
iR
iR
iR
iR
iR
"}
(6,1,1) = {"
iR
iR
iR
iR
iR
iR
iR
iR
iR
iR
iR
iR
iR
iR
Nq
Nq
vl
XO
Nq
Nq
aH
aH
aH
aH
in
iR
iR
iR
iR
iR
"}
(7,1,1) = {"
iR
iR
iR
iR
iR
iR
iR
iR
iR
iR
iR
iR
iR
iR
iR
XO
Nq
Nq
Nq
in
Sk
tc
aH
aH
aH
Bh
iR
iR
iR
iR
"}
(8,1,1) = {"
iR
iR
iR
iR
iR
iR
iR
iR
iR
iR
iR
iR
iR
iR
iR
iR
Nq
vl
in
XK
Sk
rp
aH
XW
aH
iR
iR
iR
iR
iR
"}
(9,1,1) = {"
iR
iR
iR
iR
iR
iR
iR
iR
iR
iR
iR
iR
iR
iR
iR
iR
iR
Nq
aH
XK
XK
aH
aH
iR
iR
iR
iR
iR
iR
iR
"}
(10,1,1) = {"
iR
iR
iR
iR
iR
iR
iR
iR
iR
iR
iR
in
dE
dE
iR
iR
iR
iR
iR
iR
iR
aH
in
iR
iR
iR
iR
iR
iR
iR
"}
(11,1,1) = {"
iR
iR
iR
iR
iR
iR
iR
iR
in
CZ
az
in
XK
XK
Lx
iR
iR
iR
iR
iR
iR
iR
Nq
XW
iR
iR
iR
iR
iR
iR
"}
(12,1,1) = {"
iR
iR
iR
iR
Qk
EE
yG
in
qA
in
in
qA
IP
Lx
Wk
Lx
iR
iR
iR
iR
iR
iR
iR
iR
iR
iR
iR
AG
XK
XK
"}
(13,1,1) = {"
XK
XK
CZ
wu
in
in
XV
XK
XK
XK
XK
XK
PD
XK
XK
XK
qA
XK
CZ
CZ
hY
AG
iR
iR
Rk
Yg
XK
XK
XK
XK
"}
(14,1,1) = {"
XK
in
qA
qA
in
XK
XK
fy
XK
XK
iR
in
in
XK
in
XK
XK
XK
XK
in
XK
XK
XK
XW
XK
in
qA
iR
Lx
XK
"}
(15,1,1) = {"
in
in
XK
XK
XK
XK
Lx
XK
XK
fy
XK
XK
EE
qA
in
CZ
iR
wu
XK
XK
XV
in
XK
XK
in
in
XK
in
XK
XK
"}
(16,1,1) = {"
vH
XK
XK
XV
XK
fy
XK
qA
CZ
in
XK
Hc
XK
in
wu
iR
lA
XK
XK
XK
XK
in
qA
Lx
in
XK
XK
XK
in
SY
"}
(17,1,1) = {"
XK
XK
XK
XK
XK
XK
in
AG
iR
iR
EE
XK
fy
XK
in
in
in
XK
qA
in
in
XK
XK
XW
Lx
XK
qA
in
in
in
"}
(18,1,1) = {"
XK
XK
XK
fy
XK
in
EE
oM
iR
iR
xy
XV
XK
iR
iR
OW
XK
XK
XK
XK
XK
cc
XK
XK
XK
XK
Yg
Yg
iR
iR
"}
(19,1,1) = {"
iR
XK
XK
XK
XK
in
in
xP
iR
CZ
XK
lA
iR
iR
iR
iR
Yg
in
EE
fy
XK
XK
XK
Lx
DA
iR
iR
iR
iR
iR
"}
(20,1,1) = {"
iR
XK
XK
Ft
XV
XK
XK
XK
XK
XK
XK
CZ
iR
iR
iR
iR
qA
in
XK
xP
rr
qA
if
XW
iR
iR
iR
iR
iR
iR
"}
(21,1,1) = {"
iR
iR
XK
fy
XK
Lx
AG
XV
XK
in
qA
mj
iR
iR
iR
iR
rU
iR
iR
iR
iR
iR
iR
iR
iR
iR
iR
Nq
iR
iR
"}
(22,1,1) = {"
iR
iR
in
XK
XK
XK
XK
XK
in
in
ew
iR
iR
iR
iR
iR
iR
iR
iR
iR
Nq
iL
iR
iR
XK
in
Nq
wj
Nq
iR
"}
(23,1,1) = {"
iR
iR
lA
qA
qA
IP
XV
gp
qA
sF
iR
iR
iR
iR
iR
iR
iR
iR
iR
wj
Nq
XK
iR
XW
XK
tc
oB
in
iR
iR
"}
(24,1,1) = {"
iR
iR
iR
lA
in
in
in
in
CZ
iR
iR
iR
mu
iR
iR
iR
iR
iR
si
Nq
XK
XK
XK
iR
XK
rp
oB
in
vl
iR
"}
(25,1,1) = {"
iR
iR
iR
iR
lA
xP
iv
Ly
iR
iR
iR
aH
Nq
aH
iR
iR
iR
XK
XK
XK
XK
XK
XK
XK
XK
XK
in
in
Nq
iR
"}
(26,1,1) = {"
iR
iR
iR
iR
iR
iR
iR
iR
iR
iR
Nq
vl
Nq
Nq
Nq
XK
NC
NC
XK
XK
XK
XK
XK
XK
XK
in
Nq
iR
iR
iR
"}
(27,1,1) = {"
iR
iR
iR
iR
iR
iR
iR
iR
iR
iR
XK
Nq
WI
Nq
XK
NC
NC
NC
mJ
NC
XK
XK
iR
iR
Nq
Nq
Nq
AF
iR
iR
"}
(28,1,1) = {"
iR
iR
iR
iR
iR
iR
iR
iR
iR
iR
XK
XK
XK
XK
XK
NC
hQ
iR
iR
NC
mJ
iR
iR
iR
Nq
vl
iR
iR
iR
iR
"}
(29,1,1) = {"
iR
iR
iR
iR
iR
iR
iR
iR
iR
iR
iR
XK
XK
NC
NC
NC
hQ
iR
iR
Vc
hQ
NC
XK
Nq
Nq
iR
iR
iR
iR
iR
"}
(30,1,1) = {"
iR
iR
iR
iR
iR
iR
iR
iR
iR
iR
iR
iR
iR
NC
jc
NC
iR
iR
iR
iR
iR
iR
iR
iR
iR
iR
iR
iR
iR
iR
"}

(1,1,2) = {"
iR
iR
iR
iR
iR
iR
iR
iR
iR
iR
iR
iR
iR
aH
aH
aH
iR
iR
iR
iR
iR
iR
iR
iR
iR
iR
iR
iR
iR
iR
"}
(2,1,2) = {"
iR
iR
iR
iR
iR
iR
iR
iR
iR
iR
iR
iR
aG
aH
aH
aH
aH
aX
aX
in
Bh
Bh
Nq
Nq
Nq
GC
GC
GC
iR
iR
"}
(3,1,2) = {"
iR
iR
iR
Oh
vg
Dz
Pt
iR
iR
iR
iR
iR
iR
aH
aH
aH
aX
aX
in
in
XK
OL
Fy
CI
iR
iR
GC
GC
GC
iR
"}
(4,1,2) = {"
iR
iR
iR
Pt
Co
vg
Co
eL
mu
iR
iR
mu
aH
aH
aH
aH
aX
aX
aX
aX
in
in
in
SP
XK
iR
iR
GC
Cj
iR
"}
(5,1,2) = {"
iR
iR
iR
iR
bo
MV
aH
aH
mu
iR
iR
iR
aH
Nr
aH
aX
aX
aX
aX
aX
aX
aX
XK
XK
XK
Nq
iR
iR
EP
iR
"}
(6,1,2) = {"
iR
iR
iR
iR
aH
Co
vd
aH
iR
iR
iR
mu
aH
iR
XK
aX
aX
aX
aX
aX
aX
aX
aH
XK
XK
XK
Nq
iR
iR
iR
"}
(7,1,2) = {"
iR
iR
iR
iR
vd
aH
iR
aH
iR
iR
iR
iR
aH
in
XK
iR
iR
aX
aX
aX
aX
Sk
pr
pr
pr
in
Nq
Nq
iR
iR
"}
(8,1,2) = {"
iR
iR
iR
aH
QX
iR
aH
aH
iR
iR
iR
iR
iR
iR
in
iR
iR
aX
aX
aX
aX
Sk
pr
pr
pr
in
aG
iR
iR
iR
"}
(9,1,2) = {"
iR
iR
iR
iR
iR
iR
yN
iR
iR
iR
iR
iR
iR
iR
aH
iR
iR
iR
aX
aX
iR
iR
iR
pr
pr
aH
in
aH
iR
iR
"}
(10,1,2) = {"
iR
iR
iR
iR
iR
iR
yN
iR
iR
iR
iR
aX
aX
aX
aH
iR
iR
iR
iR
iR
iR
iR
iR
pr
pr
aH
iR
iR
iR
iR
"}
(11,1,2) = {"
iR
iR
iR
iR
iR
mu
aH
iR
aX
aX
aX
aX
aX
aX
aH
iR
iR
iR
iR
iR
iR
iR
iR
pr
pr
aH
mu
iR
iR
iR
"}
(12,1,2) = {"
vg
iR
iR
iR
aH
aH
vg
iR
aX
aX
aX
aX
aX
aX
aH
aH
iR
iR
iR
iR
iR
iR
pr
pr
pr
aH
aH
aH
iR
iR
"}
(13,1,2) = {"
aH
aH
XK
XK
XK
aH
aH
aH
aH
aX
aX
aX
aX
aX
aX
aH
iR
iR
aX
aX
aX
aX
pr
pr
pr
aX
iR
aH
iR
iR
"}
(14,1,2) = {"
aH
XK
XK
XK
XK
XK
XK
aH
aH
aX
aH
aH
aX
aX
vg
aH
iR
aX
aX
aX
aX
aX
pr
pr
pr
aX
aX
aH
aH
aH
"}
(15,1,2) = {"
XK
XK
in
in
kh
XK
iR
iR
aX
aX
aX
Xc
aX
aX
aX
iR
iR
aX
aX
aX
aX
aX
pr
pr
pr
aX
aX
aX
aH
aH
"}
(16,1,2) = {"
in
in
in
iR
iR
iR
iR
iR
aX
aX
aX
iR
iR
aX
iR
iR
aX
aX
aX
aX
aX
aX
pr
pr
pr
aX
aX
aX
aX
aH
"}
(17,1,2) = {"
in
XK
XK
iR
iR
iR
vg
aH
aH
aH
aX
iR
iR
iR
iR
iR
aX
aX
aX
aX
aX
aX
pr
pr
pr
aX
aX
aX
aH
aH
"}
(18,1,2) = {"
iR
iR
XK
XK
XK
XK
in
in
aH
ah
iR
iR
iR
iR
iR
iR
iR
aX
aX
aX
aX
aX
pr
pr
pr
aX
aX
aH
aH
iR
"}
(19,1,2) = {"
iR
iR
iR
iR
iR
XK
XK
in
in
iR
iR
iR
iR
iR
iR
iR
iR
iR
iR
aX
aX
aX
pr
pr
pr
iR
iR
iR
iR
iR
"}
(20,1,2) = {"
iR
iR
iR
iR
iR
aH
XK
fm
iR
iR
iR
iR
aG
iR
gT
vg
iR
iR
iR
iR
iR
iR
pr
pr
pr
iR
iR
iR
iR
iR
"}
(21,1,2) = {"
iR
iR
iR
aH
aH
aH
xc
iR
iR
iR
aH
dr
aH
iR
iR
AQ
iR
iR
iR
iR
iR
iR
pr
pr
iR
iR
iR
iR
iR
iR
"}
(22,1,2) = {"
iR
BF
aH
aH
iR
iR
iR
iR
iR
iR
aH
iR
aH
IB
iR
aH
iR
iR
iR
iR
aX
aX
pr
pr
iR
iR
iR
iR
iR
iR
"}
(23,1,2) = {"
iR
aH
aH
iR
iR
iR
IB
iR
iR
iR
aH
iR
aH
iR
iR
Eq
aH
iR
iR
aX
aX
aX
pr
pr
pr
oB
aX
iR
iR
iR
"}
(24,1,2) = {"
iR
aH
iR
iR
iR
iR
aH
iR
eK
aH
aG
iR
mN
aH
iR
iR
aH
iR
iR
aX
aX
aX
pr
pr
pr
oB
aX
aX
iR
iR
"}
(25,1,2) = {"
iR
aH
aH
aH
aH
aG
aH
iR
aH
iR
iR
iR
iR
aG
iR
iR
aH
iR
iR
iR
aX
aX
aX
aX
aX
aX
aX
aX
iR
iR
"}
(26,1,2) = {"
iR
aH
iR
iR
iR
aH
iR
iR
aH
aH
aH
aH
aH
aH
aH
iR
aH
iR
iR
aX
aX
aX
aX
aX
aX
aX
aX
iR
iR
iR
"}
(27,1,2) = {"
iR
aH
iR
iR
iR
aH
tW
aH
zU
AQ
iR
iR
aH
vg
aH
aH
aH
iR
iR
iR
aX
aX
aH
aH
aX
iR
iR
iR
iR
iR
"}
(28,1,2) = {"
iR
aH
aH
aH
iR
aH
iR
iR
iR
iR
iR
iR
iR
iR
iR
aH
aH
Cq
iR
iR
aX
Ei
aH
DH
iR
iR
iR
iR
iR
iR
"}
(29,1,2) = {"
iR
iR
iR
aG
vg
aH
iR
iR
iR
iR
iR
iR
iR
iR
iR
aH
aH
vg
iR
iR
iR
MX
bd
iR
iR
iR
iR
iR
iR
iR
"}
(30,1,2) = {"
iR
iR
iR
iR
iR
iR
iR
iR
iR
iR
iR
iR
iR
iR
aH
aH
aH
iR
iR
iR
iR
iR
iR
iR
iR
iR
iR
iR
iR
iR
"}
