//MAP CONVERTED BY dmm2tgm.py THIS HEADER COMMENT PREVENTS RECONVERSION, DO NOT REMOVE
"ac" = (
/obj/structure/fluff/railing/border{
	dir = 4
	},
/obj/structure/flora/grass,
/obj/structure/flora/ausbushes/brflowers,
/turf/open/floor/grass/red,
/area/rogue/under/cavelava)
"ad" = (
/obj/structure/flora/grass/bush,
/turf/open/floor/dirt,
/area/rogue/under/cavelava)
"aj" = (
/turf/open/transparent/openspace,
/area/rogue/under/cavelava)
"bz" = (
/obj/structure/closet/crate/chest/wicker,
/obj/item/reagent_containers/glass/bottle/vial,
/obj/item/reagent_containers/glass/bottle/vial,
/obj/item/reagent_containers/glass/bottle/vial,
/obj/item/reagent_containers/glass/bottle,
/obj/item/reagent_containers/glass/bottle,
/obj/item/reagent_containers/glass/bottle,
/turf/open/floor/carpet/royalblack,
/area/rogue/under/cavelava)
"cq" = (
/obj/machinery/light/fueled/wallfire/candle/blue,
/turf/open/floor/ruinedwood/spiral,
/area/rogue/under/cavelava)
"cr" = (
/turf/closed/wall/mineral/stone/window,
/area/rogue/under/cavelava)
"cV" = (
/obj/structure/fluff/railing/border,
/obj/effect/decal/cleanable/sigil/SE,
/turf/open/floor/carpet/royalblack,
/area/rogue/under/cavelava)
"cX" = (
/obj/structure/fluff/railing/border{
	dir = 8
	},
/obj/structure/flora/grass,
/obj/structure/flora/ausbushes/ywflowers,
/obj/structure/flora/ausbushes/brflowers,
/turf/open/floor/grass/red,
/area/rogue/under/cavelava)
"cZ" = (
/obj/effect/dungeon_directional_helper/west,
/turf/open/floor/cobble,
/area/rogue/under/cavelava)
"dd" = (
/obj/structure/table/wood{
	icon_state = "tablewood1"
	},
/obj/item/bath/soap,
/turf/open/floor/hexstone,
/area/rogue/under/cavelava)
"dx" = (
/obj/structure/flora/grass,
/obj/item/alch/waterdust,
/turf/open/floor/dirt,
/area/rogue/under/cavelava)
"eE" = (
/obj/structure/flora/ausbushes/ywflowers,
/obj/structure/flora/ausbushes/brflowers,
/turf/open/floor/grass/red,
/area/rogue/under/cavelava)
"eN" = (
/obj/structure/flora/tree/burnt,
/turf/open/floor/grass/red,
/area/rogue/under/cavelava)
"eT" = (
/obj/structure/flora/ausbushes/brflowers,
/turf/open/floor/dirt,
/area/rogue/under/cavelava)
"fe" = (
/obj/structure/fluff/railing/border{
	dir = 4
	},
/turf/open/floor/carpet/royalblack,
/area/rogue/under/cavelava)
"fi" = (
/obj/structure/flora/grass,
/turf/open/floor/dirt,
/area/rogue/under/cavelava)
"fx" = (
/obj/structure/fluff/railing/border{
	dir = 4
	},
/turf/open/transparent/openspace,
/area/rogue/under/cavelava)
"fz" = (
/obj/structure/rack/shelf/biggest,
/obj/item/reagent_containers/glass/bucket,
/obj/item/natural/bundle/stick,
/obj/structure/fluff/walldeco/church/line{
	dir = 4
	},
/turf/open/floor/hexstone,
/area/rogue/under/cavelava)
"fL" = (
/obj/structure/fluff/railing/border{
	dir = 1
	},
/turf/open/floor/dirt,
/area/rogue/under/cavelava)
"fU" = (
/obj/structure/flora/grass,
/turf/open/floor/grass/red,
/area/rogue/under/cavelava)
"gD" = (
/obj/structure/fluff/railing/border,
/turf/open/floor/metal,
/area/rogue/under/cavelava)
"hi" = (
/mob/living/carbon/human/species/skeleton/npc/warrior/skilled,
/turf/open/floor/carpet/royalblack,
/area/rogue/under/cavelava)
"hS" = (
/obj/structure/flora/ausbushes/brflowers,
/obj/structure/flora/grass,
/turf/open/floor/dirt,
/area/rogue/under/cavelava)
"ig" = (
/obj/machinery/light/fueled/cauldron,
/obj/effect/decal/cleanable/sigil/N,
/obj/structure/fluff/walldeco/church/line,
/turf/open/floor/hexstone,
/area/rogue/under/cavelava)
"ii" = (
/mob/living/carbon/human/species/skeleton/npc/peasant,
/turf/open/floor/carpet/royalblack,
/area/rogue/under/cavelava)
"iK" = (
/obj/effect/decal/cleanable/sigil/E,
/turf/open/floor/carpet/royalblack,
/area/rogue/under/cavelava)
"jj" = (
/obj/structure/fluff/railing/border{
	dir = 8
	},
/obj/structure/flora/grass/bush_meagre,
/turf/open/floor/grass/red,
/area/rogue/under/cavelava)
"jk" = (
/turf/open/floor/carpet/royalblack,
/area/rogue/under/cavelava)
"jK" = (
/obj/structure/flora/ausbushes/brflowers,
/turf/open/floor/grass/red,
/area/rogue/under/cavelava)
"kU" = (
/obj/machinery/light/fueled/hearth,
/turf/open/floor/hexstone,
/area/rogue/under/cavelava)
"lq" = (
/obj/structure/fluff/walldeco/church/line,
/turf/open/floor/hexstone,
/area/rogue/under/cavelava)
"lF" = (
/obj/structure/flora/ausbushes/ywflowers,
/obj/structure/flora/ausbushes/brflowers,
/turf/open/floor/dirt,
/area/rogue/under/cavelava)
"lS" = (
/turf/closed/wall/mineral/stone,
/area/rogue/under/cavelava)
"lW" = (
/obj/structure/fluff/railing/border{
	dir = 10
	},
/turf/open/floor/carpet/royalblack,
/area/rogue/under/cavelava)
"mo" = (
/obj/structure/composter/halffull,
/turf/open/floor/hexstone,
/area/rogue/under/cavelava)
"mF" = (
/obj/structure/chair/wood/alt/chair_noble,
/turf/open/floor/carpet/royalblack,
/area/rogue/under/cavelava)
"mY" = (
/obj/item/bin/water,
/turf/open/floor/hexstone,
/area/rogue/under/cavelava)
"mZ" = (
/obj/structure/closet/crate/chest/wicker,
/obj/item/clothing/face/spectacles/golden,
/turf/open/floor/carpet/royalblack,
/area/rogue/under/cavelava)
"nc" = (
/obj/structure/fluff/railing/border,
/turf/open/transparent/openspace,
/area/rogue/under/cavelava)
"nm" = (
/obj/machinery/light/fueled/wallfire/candle/blue{
	pixel_y = -32
	},
/mob/living/carbon/human/species/skeleton/npc/peasant,
/turf/open/floor/hexstone,
/area/rogue/under/cavelava)
"nu" = (
/obj/machinery/light/fueled/wallfire/candle/blue{
	pixel_y = -32
	},
/turf/open/floor/ruinedwood/spiral,
/area/rogue/under/cavelava)
"om" = (
/obj/structure/fermentation_keg/water,
/turf/open/floor/ruinedwood/spiral,
/area/rogue/under/cavelava)
"oG" = (
/obj/machinery/light/fueled/wallfire/candle/blue/l,
/mob/living/carbon/human/species/skeleton/npc/warrior/skilled,
/turf/open/floor/carpet/royalblack,
/area/rogue/under/cavelava)
"pY" = (
/obj/effect/decal/cleanable/sigil,
/obj/item/weapon/knife/dagger/silver,
/obj/item/reagent_containers/powder/moondust_purest,
/turf/open/floor/carpet/royalblack,
/area/rogue/under/cavelava)
"qh" = (
/turf/open/floor/hexstone,
/area/rogue/under/cavelava)
"qp" = (
/obj/machinery/light/fueled/wallfire/candle/blue{
	pixel_x = 32;
	pixel_y = 0
	},
/turf/open/floor/ruinedwood/spiral,
/area/rogue/under/cavelava)
"qG" = (
/obj/machinery/tanningrack,
/turf/open/floor/ruinedwood/spiral,
/area/rogue/under/cavelava)
"rz" = (
/obj/structure/closet/crate/crafted_closet/dark,
/obj/item/alch/swampdust,
/obj/item/alch/runedust,
/obj/item/alch/tobaccodust,
/turf/open/floor/hexstone,
/area/rogue/under/cavelava)
"sc" = (
/obj/structure/mineral_door/wood/donjon/stone,
/turf/open/floor/cobble,
/area/rogue/under/cavelava)
"sv" = (
/obj/structure/fluff/railing/border{
	dir = 5
	},
/obj/structure/flora/grass,
/obj/structure/flora/ausbushes/ywflowers,
/obj/structure/flora/ausbushes/brflowers,
/obj/structure/fluff/telescope,
/turf/open/floor/grass/red,
/area/rogue/under/cavelava)
"sG" = (
/obj/structure/fluff/railing/border{
	dir = 8
	},
/turf/open/transparent/openspace,
/area/rogue/under/cavelava)
"tF" = (
/obj/structure/closet/crate/crafted_closet/inn,
/obj/item/book/magicaltheory,
/obj/item/book/granter/spell/magick/fireball,
/obj/item/scomstone/bad,
/turf/open/floor/carpet/royalblack,
/area/rogue/under/cavelava)
"ut" = (
/obj/structure/fluff/railing/border{
	dir = 4
	},
/obj/structure/flora/grass/bush_meagre,
/turf/open/floor/grass/red,
/area/rogue/under/cavelava)
"uy" = (
/obj/structure/closet/crate/crafted_closet/dark,
/obj/item/alch/swampdust,
/obj/item/alch/runedust,
/obj/item/alch/tobaccodust,
/obj/structure/fluff/walldeco/church/line{
	dir = 8
	},
/turf/open/floor/hexstone,
/area/rogue/under/cavelava)
"uX" = (
/mob/living/carbon/human/species/skeleton/npc/ambush,
/turf/open/floor/carpet/royalblack,
/area/rogue/under/cavelava)
"vB" = (
/obj/structure/circle_protection,
/obj/item/alch/firedust,
/obj/item/weapon/sword/silver,
/turf/open/floor/hexstone,
/area/rogue/under/cavelava)
"wm" = (
/obj/structure/fluff/railing/border{
	dir = 4
	},
/turf/open/floor/metal{
	icon_state = "plating2"
	},
/area/rogue/under/cavelava)
"xt" = (
/obj/structure/table/wood{
	icon_state = "tablewood1"
	},
/obj/item/soap,
/turf/open/floor/hexstone,
/area/rogue/under/cavelava)
"xG" = (
/obj/effect/decal/cleanable/sigil/W,
/turf/open/floor/carpet/royalblack,
/area/rogue/under/cavelava)
"xI" = (
/obj/structure/table/wood{
	icon_state = "tablewood1"
	},
/turf/open/floor/ruinedwood/spiral,
/area/rogue/under/cavelava)
"xO" = (
/obj/effect/dungeon_directional_helper/east,
/turf/open/floor/cobble,
/area/rogue/under/cavelava)
"xR" = (
/obj/structure/fluff/buysign{
	name = "If you are reading this, the Ten says you are a nerd."
	},
/turf/open/floor/grass/red,
/area/rogue/under/cavelava)
"yc" = (
/obj/effect/decal/cleanable/sigil/NE,
/obj/machinery/light/fueled/hearth,
/obj/item/reagent_containers/glass/bucket/pot,
/obj/structure/fluff/walldeco/church/line,
/turf/open/floor/hexstone,
/area/rogue/under/cavelava)
"yp" = (
/turf/open/floor/dirt,
/area/rogue/under/cavelava)
"yG" = (
/obj/structure/closet/crate/chest/neu_fancy,
/obj/item/weapon/sickle,
/obj/item/weapon/pitchfork,
/obj/item/weapon/hoe,
/obj/item/weapon/thresher,
/obj/item/reagent_containers/glass/bucket/wooden,
/obj/item/weapon/shovel,
/turf/open/floor/hexstone,
/area/rogue/under/cavelava)
"yI" = (
/obj/structure/fluff/walldeco/church/line,
/obj/structure/fluff/walldeco/church/line{
	dir = 4
	},
/mob/living/carbon/human/species/skeleton/npc/warrior,
/turf/open/floor/hexstone,
/area/rogue/under/cavelava)
"yN" = (
/obj/structure/mineral_door/wood/donjon/stone,
/turf/open/floor/ruinedwood/spiral,
/area/rogue/under/cavelava)
"yW" = (
/obj/structure/table/wood/treestump/burnt,
/turf/open/floor/grass/red,
/area/rogue/under/cavelava)
"AD" = (
/obj/structure/fluff/railing/border,
/obj/effect/decal/cleanable/sigil/S,
/turf/open/floor/carpet/royalblack,
/area/rogue/under/cavelava)
"Bk" = (
/obj/structure/bookcase/random/myths,
/turf/open/floor/ruinedwood/spiral,
/area/rogue/under/cavelava)
"CP" = (
/mob/living/simple_animal/hostile/skeleton/bow,
/turf/open/floor/carpet/royalblack,
/area/rogue/under/cavelava)
"CQ" = (
/obj/structure/fluff/railing/border,
/turf/open/floor/carpet/royalblack,
/area/rogue/under/cavelava)
"CW" = (
/obj/structure/flora/ausbushes/brflowers,
/obj/structure/flora/ausbushes/ywflowers,
/obj/structure/flora/grass,
/turf/open/floor/dirt,
/area/rogue/under/cavelava)
"Dc" = (
/obj/structure/flora/tree/burnt,
/turf/open/floor/dirt,
/area/rogue/under/cavelava)
"DM" = (
/obj/structure/fluff/railing/border{
	dir = 10
	},
/mob/living/carbon/human/species/skeleton/npc/warrior/skilled,
/turf/open/floor/carpet/royalblack,
/area/rogue/under/cavelava)
"DO" = (
/obj/structure/flora/ausbushes/brflowers,
/obj/structure/flora/ausbushes/brflowers,
/obj/structure/flora/ausbushes/ywflowers,
/obj/structure/flora/grass,
/obj/structure/flora/tree/burnt,
/turf/open/floor/grass/red,
/area/rogue/under/cavelava)
"Es" = (
/turf/closed/mineral/bedrock,
/area/rogue/under/cavelava)
"EQ" = (
/obj/structure/fluff/railing/border{
	dir = 8
	},
/turf/open/floor/metal{
	icon_state = "plating2"
	},
/area/rogue/under/cavelava)
"Fa" = (
/obj/machinery/light/fueled/oven/west,
/obj/structure/closet/crate/chest,
/obj/item/cooking/pan,
/obj/item/reagent_containers/food/snacks/meat/mince,
/obj/item/reagent_containers/food/snacks/meat/mince,
/obj/item/reagent_containers/food/snacks/meat/mince,
/obj/item/reagent_containers/food/snacks/meat/mince,
/obj/item/reagent_containers/food/snacks/meat/poultry,
/obj/item/reagent_containers/food/snacks/meat/poultry,
/turf/open/floor/hexstone,
/area/rogue/under/cavelava)
"Ga" = (
/obj/machinery/light/fueled/wallfire/candle/blue{
	pixel_x = -32;
	pixel_y = 0
	},
/turf/open/floor/ruinedwood/spiral,
/area/rogue/under/cavelava)
"Gc" = (
/obj/structure/table/wood/treestump/burnt,
/turf/open/floor/dirt,
/area/rogue/under/cavelava)
"Ha" = (
/obj/effect/dungeon_directional_helper/south,
/turf/open/floor/cobble,
/area/rogue/under/cavelava)
"Hh" = (
/turf/open/floor/ruinedwood/spiral,
/area/rogue/under/cavelava)
"HP" = (
/obj/effect/dungeon_directional_helper/north,
/turf/open/floor/cobble,
/area/rogue/under/cavelava)
"HT" = (
/obj/structure/table/wood{
	icon_state = "tablewood1"
	},
/turf/open/floor/hexstone,
/area/rogue/under/cavelava)
"HY" = (
/obj/structure/stairs/stone{
	dir = 1
	},
/turf/open/floor/ruinedwood/turned/darker,
/area/rogue/under/cavelava)
"Ik" = (
/obj/structure/flora/ausbushes/ywflowers,
/turf/open/floor/dirt,
/area/rogue/under/cavelava)
"IC" = (
/obj/structure/fluff/railing/border{
	dir = 5
	},
/turf/open/transparent/openspace,
/area/rogue/under/cavelava)
"IH" = (
/obj/structure/rack/shelf/biggest,
/obj/item/mortar,
/obj/item/pestle,
/turf/open/floor/hexstone,
/area/rogue/under/cavelava)
"Jf" = (
/turf/open/floor/grass/red,
/area/rogue/under/cavelava)
"Jl" = (
/obj/structure/fluff/railing/border{
	dir = 6
	},
/turf/open/transparent/openspace,
/area/rogue/under/cavelava)
"JG" = (
/turf/open/floor/cobble,
/area/rogue/under/cavelava)
"Kt" = (
/mob/living/carbon/human/species/skeleton/npc/peasant,
/turf/open/floor/hexstone,
/area/rogue/under/cavelava)
"KP" = (
/obj/machinery/light/fueled/wallfire/candle/blue/r,
/turf/open/floor/carpet/royalblack,
/area/rogue/under/cavelava)
"KW" = (
/obj/structure/flora/ausbushes/brflowers,
/obj/structure/flora/ausbushes/ywflowers,
/turf/open/floor/grass/red,
/area/rogue/under/cavelava)
"LG" = (
/obj/structure/fluff/railing/border{
	dir = 8
	},
/turf/open/floor/carpet/royalblack,
/area/rogue/under/cavelava)
"LP" = (
/obj/structure/circle_protection,
/obj/item/alch/firedust,
/obj/item/weapon/sword/rapier/silver,
/turf/open/floor/hexstone,
/area/rogue/under/cavelava)
"MG" = (
/obj/machinery/light/fueled/wallfire/candle/blue,
/turf/open/floor/hexstone,
/area/rogue/under/cavelava)
"MH" = (
/obj/structure/fluff/railing/border{
	dir = 10
	},
/turf/open/transparent/openspace,
/area/rogue/under/cavelava)
"NO" = (
/turf/open/lava,
/area/rogue/under/cavelava)
"Om" = (
/obj/structure/well,
/turf/open/floor/grass/red,
/area/rogue/under/cavelava)
"OF" = (
/obj/machinery/light/fueled/wallfire/candle/blue{
	pixel_y = -32
	},
/turf/open/floor/hexstone,
/area/rogue/under/cavelava)
"OR" = (
/obj/structure/fluff/railing/border{
	dir = 6
	},
/obj/structure/fluff/railing/border{
	dir = 6
	},
/obj/structure/fluff/railing/border{
	dir = 6
	},
/turf/open/floor/carpet/royalblack,
/area/rogue/under/cavelava)
"OY" = (
/obj/structure/stairs/stone{
	dir = 1
	},
/turf/open/floor/blocks,
/area/rogue/under/cavelava)
"PJ" = (
/obj/structure/fluff/railing/border{
	dir = 9
	},
/obj/structure/flora/grass,
/turf/open/floor/grass/red,
/area/rogue/under/cavelava)
"Qf" = (
/obj/structure/chair/wood/alt/chair_noble{
	dir = 4
	},
/turf/open/floor/carpet/royalblack,
/area/rogue/under/cavelava)
"Qk" = (
/mob/living/simple_animal/hostile/skeleton/bow,
/turf/open/floor/hexstone,
/area/rogue/under/cavelava)
"QB" = (
/obj/structure/fluff/railing/border{
	dir = 4
	},
/mob/living/carbon/human/species/skeleton/npc/ambush,
/turf/open/floor/carpet/royalblack,
/area/rogue/under/cavelava)
"QC" = (
/obj/structure/fluff/railing/border{
	dir = 1
	},
/turf/open/transparent/openspace,
/area/rogue/under/cavelava)
"RH" = (
/obj/structure/fluff/railing/border{
	dir = 9
	},
/turf/open/transparent/openspace,
/area/rogue/under/cavelava)
"SI" = (
/obj/structure/fluff/railing/border{
	dir = 9
	},
/turf/open/floor/carpet/royalblack,
/area/rogue/under/cavelava)
"Ta" = (
/turf/open/floor/metal,
/area/rogue/under/cavelava)
"Tc" = (
/obj/structure/table/wood{
	icon_state = "tablewood1"
	},
/obj/item/broom,
/turf/open/floor/hexstone,
/area/rogue/under/cavelava)
"Tk" = (
/obj/structure/fluff/railing/border{
	dir = 6
	},
/mob/living/carbon/human/species/skeleton/npc/peasant,
/turf/open/floor/carpet/royalblack,
/area/rogue/under/cavelava)
"TN" = (
/obj/structure/flora/ausbushes/ywflowers,
/obj/structure/flora/ausbushes/brflowers,
/obj/structure/flora/grass,
/turf/open/floor/grass/red,
/area/rogue/under/cavelava)
"TQ" = (
/obj/structure/fluff/railing/border{
	dir = 1
	},
/turf/open/floor/metal,
/area/rogue/under/cavelava)
"Uo" = (
/obj/structure/fluff/railing/border{
	dir = 5
	},
/turf/open/floor/carpet/royalblack,
/area/rogue/under/cavelava)
"Ut" = (
/obj/structure/flora/ausbushes/brflowers,
/obj/structure/flora/ausbushes/ywflowers,
/turf/open/floor/dirt,
/area/rogue/under/cavelava)
"Uz" = (
/obj/structure/bookcase/random/thesis,
/turf/open/floor/ruinedwood/spiral,
/area/rogue/under/cavelava)
"UG" = (
/obj/structure/bed/inn/double,
/obj/item/bedsheet/fabric_double,
/turf/open/floor/carpet/royalblack,
/area/rogue/under/cavelava)
"Vh" = (
/obj/machinery/light/fueled/wallfire/candle,
/turf/open/floor/grass/red,
/area/rogue/under/cavelava)
"Vm" = (
/obj/structure/flora/grass/bush/wall/tall,
/turf/open/floor/grass/red,
/area/rogue/under/cavelava)
"VJ" = (
/obj/structure/flora/ausbushes/brflowers,
/obj/structure/flora/ausbushes/ywflowers,
/obj/structure/flora/grass,
/turf/open/floor/grass/red,
/area/rogue/under/cavelava)
"VM" = (
/obj/structure/flora/ausbushes/ywflowers,
/obj/structure/flora/ausbushes/brflowers,
/obj/structure/flora/grass,
/turf/open/floor/dirt,
/area/rogue/under/cavelava)
"Wp" = (
/obj/structure/flora/ausbushes/ywflowers,
/turf/open/floor/grass/red,
/area/rogue/under/cavelava)
"WF" = (
/obj/structure/fluff/walldeco/church/line,
/obj/structure/fluff/walldeco/church/line{
	dir = 8
	},
/turf/open/floor/hexstone,
/area/rogue/under/cavelava)
"WV" = (
/obj/structure/flora/grass/bush,
/turf/open/floor/grass/red,
/area/rogue/under/cavelava)
"Xh" = (
/turf/open/floor/metal{
	icon_state = "plating2"
	},
/area/rogue/under/cavelava)
"Xm" = (
/turf/closed/wall/mineral/stone/moss,
/area/rogue/under/cavelava)
"Yo" = (
/obj/structure/fluff/railing/border,
/obj/effect/decal/cleanable/sigil/SW,
/turf/open/floor/carpet/royalblack,
/area/rogue/under/cavelava)
"Yw" = (
/obj/structure/closet/crate/chest/neu_fancy,
/obj/item/neuFarm/seed/poison_berries,
/obj/item/neuFarm/seed/swampleaf,
/obj/item/neuFarm/seed/westleach,
/obj/item/neuFarm/seed/wheat,
/turf/open/floor/hexstone,
/area/rogue/under/cavelava)
"Za" = (
/obj/item/alch/magicdust,
/obj/structure/fluff/railing/border{
	dir = 8
	},
/turf/open/floor/carpet/royalblack,
/area/rogue/under/cavelava)
"Zr" = (
/obj/effect/decal/cleanable/sigil/NW,
/obj/machinery/light/fueled/hearth,
/obj/item/reagent_containers/glass/bucket/pot,
/obj/structure/fluff/walldeco/church/line,
/turf/open/floor/hexstone,
/area/rogue/under/cavelava)
"ZO" = (
/obj/machinery/light/fueled/wallfire/candle/blue{
	pixel_x = 32;
	pixel_y = 0
	},
/mob/living/carbon/human/species/skeleton/npc/ambush,
/turf/open/floor/ruinedwood/spiral,
/area/rogue/under/cavelava)

(1,1,1) = {"
Es
Es
Es
Es
Es
Es
Es
Es
Es
Es
Es
Es
Es
TQ
cZ
gD
Es
Es
Es
Es
Es
Es
Es
Es
Es
Es
Es
Es
Es
Es
"}
(2,1,1) = {"
Es
Es
Es
Es
Es
Es
Es
Es
NO
NO
NO
NO
JG
TQ
JG
gD
JG
NO
NO
NO
NO
NO
NO
Es
Es
Es
Es
Es
Es
Es
"}
(3,1,1) = {"
Es
Es
Es
Es
Es
NO
NO
NO
NO
NO
NO
NO
JG
TQ
JG
gD
JG
NO
NO
NO
JG
JG
JG
NO
Es
Es
Es
Es
Es
Es
"}
(4,1,1) = {"
Es
Es
Es
Es
NO
NO
JG
JG
NO
NO
JG
NO
NO
Ta
JG
Ta
NO
NO
NO
NO
NO
NO
JG
JG
NO
Es
Es
Es
Es
Es
"}
(5,1,1) = {"
Es
Es
Es
Es
NO
NO
NO
JG
JG
NO
JG
NO
NO
NO
NO
NO
NO
NO
NO
JG
JG
NO
JG
NO
NO
Es
Es
Es
Es
Es
"}
(6,1,1) = {"
Es
Es
Es
JG
JG
NO
NO
NO
NO
NO
JG
JG
NO
JG
NO
JG
JG
NO
NO
JG
NO
NO
NO
NO
JG
NO
Es
Es
Es
Es
"}
(7,1,1) = {"
Es
Es
NO
JG
JG
NO
JG
JG
NO
NO
NO
NO
lS
JG
JG
NO
lS
JG
NO
NO
NO
NO
NO
JG
NO
NO
NO
Es
Es
Es
"}
(8,1,1) = {"
Es
Es
NO
NO
JG
NO
NO
JG
JG
NO
NO
NO
NO
NO
JG
JG
JG
NO
NO
NO
NO
NO
NO
NO
JG
NO
NO
NO
Es
Es
"}
(9,1,1) = {"
Es
NO
NO
NO
NO
NO
NO
JG
JG
JG
NO
JG
JG
NO
NO
NO
NO
JG
JG
JG
JG
NO
NO
NO
NO
JG
JG
NO
NO
Es
"}
(10,1,1) = {"
Es
NO
NO
NO
NO
JG
NO
NO
JG
lS
lS
lS
lS
JG
JG
JG
lS
lS
lS
lS
JG
JG
NO
NO
NO
NO
JG
JG
NO
Es
"}
(11,1,1) = {"
Es
NO
NO
NO
NO
NO
NO
NO
NO
lS
HT
dd
lS
sc
cr
sc
lS
qh
mY
lS
JG
NO
lS
NO
NO
NO
NO
NO
NO
Es
"}
(12,1,1) = {"
Es
NO
NO
NO
JG
JG
NO
NO
JG
lS
xt
qh
qh
jk
oG
jk
qh
qh
mY
lS
NO
NO
JG
JG
JG
NO
NO
NO
NO
Es
"}
(13,1,1) = {"
Es
JG
JG
NO
NO
JG
JG
NO
NO
lS
lS
MG
Tk
fe
fe
fe
Uo
OF
lS
lS
NO
NO
NO
JG
NO
JG
NO
JG
JG
Es
"}
(14,1,1) = {"
EQ
EQ
EQ
Xh
NO
NO
JG
NO
NO
JG
sc
jk
CQ
Uz
Hh
Hh
jk
jk
sc
JG
NO
JG
NO
NO
NO
NO
Xh
EQ
EQ
EQ
"}
(15,1,1) = {"
HP
JG
JG
JG
NO
NO
NO
NO
JG
JG
cr
jk
CQ
Bk
lS
HY
jk
jk
cr
JG
NO
JG
NO
JG
JG
NO
JG
JG
JG
Ha
"}
(16,1,1) = {"
wm
wm
wm
Xh
NO
JG
JG
NO
JG
JG
sc
jk
CQ
Uz
Hh
Hh
jk
jk
sc
JG
NO
JG
JG
NO
JG
NO
Xh
wm
wm
wm
"}
(17,1,1) = {"
Es
JG
JG
NO
NO
JG
NO
NO
NO
lS
lS
MG
DM
LG
LG
LG
SI
nm
lS
lS
NO
NO
JG
NO
NO
NO
NO
JG
JG
Es
"}
(18,1,1) = {"
Es
NO
NO
NO
NO
NO
NO
JG
NO
lS
HT
qh
qh
jk
KP
jk
qh
qh
qh
lS
JG
NO
NO
JG
NO
NO
NO
NO
Es
Es
"}
(19,1,1) = {"
Es
NO
NO
NO
NO
JG
NO
NO
JG
lS
HT
Tc
lS
sc
cr
sc
lS
kU
Fa
lS
JG
JG
lS
NO
NO
Es
Es
Es
Es
Es
"}
(20,1,1) = {"
Es
Es
NO
JG
NO
NO
NO
NO
JG
lS
lS
lS
lS
JG
JG
JG
lS
lS
lS
lS
NO
JG
NO
JG
JG
Es
Es
Es
Es
Es
"}
(21,1,1) = {"
Es
Es
NO
JG
JG
NO
NO
JG
JG
JG
NO
JG
NO
NO
JG
NO
NO
JG
JG
JG
JG
NO
NO
NO
Es
Es
Es
Es
Es
Es
"}
(22,1,1) = {"
Es
Es
NO
NO
JG
NO
NO
NO
JG
NO
NO
JG
JG
NO
JG
JG
NO
NO
NO
JG
JG
JG
Es
Es
Es
Es
Es
Es
Es
Es
"}
(23,1,1) = {"
Es
Es
Es
NO
JG
NO
NO
NO
NO
NO
NO
NO
NO
NO
NO
NO
NO
NO
NO
NO
NO
Es
Es
Es
Es
Es
Es
Es
Es
Es
"}
(24,1,1) = {"
Es
Es
Es
NO
NO
NO
JG
JG
JG
JG
NO
NO
lS
JG
NO
JG
lS
NO
JG
JG
NO
Es
Es
Es
Es
Es
Es
Es
Es
Es
"}
(25,1,1) = {"
Es
Es
Es
NO
NO
NO
NO
JG
JG
JG
JG
NO
NO
JG
JG
JG
JG
NO
NO
NO
Es
Es
Es
Es
Es
Jf
Jf
Es
Es
Es
"}
(26,1,1) = {"
Es
Es
Es
NO
NO
NO
JG
NO
NO
NO
NO
NO
NO
NO
NO
NO
NO
NO
NO
Es
Es
Es
Es
Es
Es
Jf
xR
Jf
Es
Es
"}
(27,1,1) = {"
Es
Es
Es
Es
NO
NO
JG
JG
NO
JG
JG
NO
NO
Ta
JG
Ta
NO
NO
NO
Es
Es
Es
Es
Es
Es
Jf
Jf
Jf
Es
Es
"}
(28,1,1) = {"
Es
Es
Es
Es
Es
Es
NO
NO
NO
JG
NO
NO
JG
TQ
JG
gD
JG
NO
NO
Es
Es
Es
Es
Es
Es
Es
Es
Es
Es
Es
"}
(29,1,1) = {"
Es
Es
Es
Es
Es
Es
Es
Es
Es
NO
NO
NO
JG
TQ
JG
gD
JG
NO
NO
Es
Es
Es
Es
Es
Es
Es
Es
Es
Es
Es
"}
(30,1,1) = {"
Es
Es
Es
Es
Es
Es
Es
Es
Es
Es
Es
Es
Es
TQ
xO
gD
Es
Es
Es
Es
Es
Es
Es
Es
Es
Es
Es
Es
Es
Es
"}

(1,1,2) = {"
Es
Es
Es
Es
Es
Es
Es
Es
Es
Es
Es
Es
Es
yp
yp
yp
Es
Es
Es
Es
Es
Es
Es
Es
Es
Es
Es
Es
Es
Es
"}
(2,1,2) = {"
Es
Jf
Jf
Jf
Jf
yp
yW
jK
Jf
Dc
Ik
yp
yp
fi
fU
fU
yp
yp
yp
Jf
Jf
Jf
fU
fU
fi
fi
yp
Jf
Jf
Es
"}
(3,1,2) = {"
Es
Jf
eN
Wp
Jf
eT
eE
eE
fU
TN
VM
yp
fi
fU
fU
Jf
fU
fi
yp
fi
fU
Jf
fU
fi
fi
fU
fU
Jf
Jf
Es
"}
(4,1,2) = {"
Es
Jf
eE
VM
fi
eT
Dc
Ik
fU
jK
yp
yp
yp
yp
Jf
Jf
Jf
yp
fi
fi
fi
fi
fi
fi
yp
yp
yW
Jf
fi
Es
"}
(5,1,2) = {"
Es
yp
fi
fi
aj
aj
aj
aj
aj
aj
aj
aj
Jl
fx
fx
fx
IC
aj
aj
aj
aj
aj
aj
aj
aj
Jf
yp
fi
fi
Es
"}
(6,1,2) = {"
Es
eT
lF
Dc
aj
aj
aj
aj
aj
aj
aj
aj
nc
qh
qh
Qk
QC
aj
aj
aj
aj
aj
aj
aj
aj
aj
yp
fi
fi
Es
"}
(7,1,2) = {"
Es
yp
lF
Ik
aj
aj
aj
aj
aj
aj
aj
aj
lS
Kt
vB
qh
lS
aj
aj
aj
aj
aj
aj
aj
aj
aj
fi
fU
fU
Es
"}
(8,1,2) = {"
Es
yp
yp
Jf
aj
aj
aj
aj
aj
aj
aj
aj
aj
qh
qh
qh
aj
aj
aj
aj
aj
aj
aj
aj
aj
aj
fU
fU
fU
Es
"}
(9,1,2) = {"
Es
Ik
Jf
jK
aj
aj
aj
aj
aj
aj
aj
aj
aj
aj
aj
aj
aj
aj
aj
aj
aj
aj
aj
aj
aj
aj
fU
fU
fU
Es
"}
(10,1,2) = {"
Es
Ik
eE
jK
aj
aj
aj
aj
aj
lS
lS
lS
lS
cr
cr
cr
lS
lS
lS
lS
aj
aj
aj
aj
aj
aj
Jf
Jf
fi
Es
"}
(11,1,2) = {"
Es
yW
eE
Jf
aj
aj
aj
aj
aj
lS
IH
lq
lS
om
qG
om
lS
jk
bz
lS
ac
ut
sv
aj
aj
aj
yp
Dc
yp
Es
"}
(12,1,2) = {"
Es
Jf
Jf
Wp
aj
aj
aj
aj
aj
lS
fz
yI
Ga
jk
jk
jk
Ga
jk
mZ
lS
mo
qh
fL
aj
aj
aj
yp
yp
yp
Es
"}
(13,1,2) = {"
Es
Jf
Wp
eE
aj
aj
aj
aj
aj
lS
lS
cq
OR
fe
QB
fe
Uo
nu
lS
lS
mo
jk
fL
aj
aj
aj
yp
Jf
fi
Es
"}
(14,1,2) = {"
Jf
fU
lF
lF
aj
aj
aj
aj
aj
cr
Zr
xG
Yo
Hh
Hh
Hh
jk
jk
cr
qh
ii
jk
fL
aj
aj
aj
yp
Jf
fU
fU
"}
(15,1,2) = {"
fi
fi
lF
yp
aj
aj
aj
aj
aj
cr
ig
pY
AD
Hh
OY
aj
jk
hi
yN
qh
jk
mF
fL
aj
aj
aj
yp
fU
fU
fU
"}
(16,1,2) = {"
fi
fi
eE
Jf
aj
aj
aj
aj
aj
cr
yc
iK
cV
Hh
Hh
Hh
jk
jk
cr
qh
jk
CP
fL
aj
aj
aj
Jf
fU
fU
Jf
"}
(17,1,2) = {"
Es
fU
Jf
Jf
aj
aj
aj
aj
aj
lS
lS
cq
lW
LG
Za
LG
SI
nu
lS
lS
Yw
uX
fL
aj
aj
aj
Jf
fU
yp
Es
"}
(18,1,2) = {"
Es
Jf
Jf
Jf
aj
aj
aj
aj
aj
lS
uy
WF
ZO
jk
Qf
jk
qp
jk
jk
lS
yG
qh
fL
aj
aj
aj
yp
fi
fi
Es
"}
(19,1,2) = {"
Es
Jf
Jf
Jf
aj
aj
aj
aj
aj
lS
rz
lq
lS
Uz
xI
xI
lS
tF
UG
lS
jj
cX
PJ
aj
aj
Jf
yp
fU
fi
Es
"}
(20,1,2) = {"
Es
yp
Jf
Jf
aj
aj
aj
aj
aj
lS
lS
lS
lS
cr
cr
cr
lS
lS
lS
lS
aj
aj
aj
aj
aj
Jf
yp
Jf
Jf
Es
"}
(21,1,2) = {"
Es
yp
yp
yp
aj
aj
aj
aj
aj
aj
aj
aj
aj
aj
aj
aj
aj
aj
aj
aj
aj
aj
aj
aj
Jf
Jf
Wp
jK
Jf
Es
"}
(22,1,2) = {"
Es
yp
yp
yp
aj
aj
aj
aj
aj
aj
aj
aj
aj
aj
aj
aj
aj
aj
aj
aj
aj
aj
Jf
yp
Jf
Gc
Wp
jK
Wp
Es
"}
(23,1,2) = {"
Es
yp
Jf
yp
aj
aj
aj
aj
aj
aj
aj
aj
aj
qh
qh
qh
aj
aj
aj
aj
aj
Jf
fU
fi
yp
jK
Ut
jK
jK
Es
"}
(24,1,2) = {"
Es
Jf
Jf
yp
aj
aj
aj
aj
aj
aj
aj
aj
lS
qh
LP
Kt
lS
aj
aj
aj
aj
Jf
yp
fU
Vm
Xm
Vh
ad
Ut
Es
"}
(25,1,2) = {"
Es
Jf
Jf
Jf
aj
aj
aj
aj
aj
aj
aj
aj
nc
qh
Qk
qh
QC
aj
aj
aj
Jf
Jf
fi
fU
Xm
Vm
Jf
fi
KW
Es
"}
(26,1,2) = {"
Es
Jf
yp
yp
aj
aj
aj
aj
aj
aj
aj
aj
MH
sG
sG
sG
RH
aj
aj
Jf
Jf
VJ
fi
fU
Xm
Om
yp
dx
fU
Es
"}
(27,1,2) = {"
Es
yp
yp
yp
Jf
Jf
yp
yp
Jf
Jf
Jf
yp
yp
yp
yp
yp
yp
yp
fi
fU
yp
CW
hS
fi
Xm
Vm
Jf
fU
fi
Es
"}
(28,1,2) = {"
Es
yp
Jf
Jf
Jf
Jf
yp
yp
Jf
Jf
Jf
Jf
yp
yp
yp
yp
fU
fU
fU
eT
Ut
DO
KW
yp
Vm
Xm
Vh
WV
fi
Es
"}
(29,1,2) = {"
Es
yp
yp
Jf
Jf
yp
yp
Jf
yp
Jf
yp
yp
yp
yp
Jf
Jf
Jf
Jf
Jf
yp
Jf
fU
jK
eT
Jf
Jf
Jf
yp
fi
Es
"}
(30,1,2) = {"
Es
Es
Es
Es
Es
Es
Es
Es
Es
Es
Es
Es
Es
Jf
Jf
Jf
Es
Es
Es
Es
Es
Es
Es
Es
Es
Es
Es
Es
Es
Es
"}
