//MAP CONVERTED BY dmm2tgm.py THIS HEADER COMMENT PREVENTS RECONVERSION, DO NOT REMOVE
"a" = (
/turf/open/transparent/openspace,
/area/rogue)
"b" = (
/turf/closed/wall/mineral/rogue/stone,
/area/rogue)
"c" = (
/obj/structure/flora/newtree/scorched,
/turf/open/floor/rogue/dirt,
/area/rogue)
"d" = (
/obj/structure/flora/newtree/scorched,
/turf/open/transparent/openspace,
/area/rogue)
"f" = (
/mob/living/carbon/human/species/goblin/hell,
/obj/effect/mapping_helpers/floor_clothing_equipper,
/obj/item/clothing/under/roguetown/trou/leather/advanced,
/obj/item/clothing/wrists/roguetown/bracers/leather,
/obj/item/rogueweapon/pick/paxe,
/turf/open/floor/rogue/cobble,
/area/rogue)
"g" = (
/turf/open/floor/rogue/cobble,
/area/rogue)
"j" = (
/obj/effect/dungeon_directional_helper/east,
/turf/open/floor/rogue/cobblerock,
/area/rogue)
"m" = (
/obj/structure/fluff/railing/wood,
/turf/open/floor/rogue/cobble,
/area/rogue)
"n" = (
/obj/machinery/light/rogue/forge,
/turf/open/floor/rogue/cobblerock,
/area/rogue)
"o" = (
/obj/structure/fluff/railing/wood{
	dir = 4
	},
/obj/structure/fluff/railing/wood{
	dir = 1;
	layer = 2.7;
	pixel_x = 2;
	pixel_y = 7
	},
/turf/open/floor/rogue/cobble,
/area/rogue)
"p" = (
/turf/open/lava,
/area/rogue)
"q" = (
/obj/effect/dungeon_directional_helper/north,
/turf/open/floor/rogue/cobblerock,
/area/rogue)
"u" = (
/obj/structure/fluff/grindwheel,
/turf/open/floor/rogue/cobblerock,
/area/rogue)
"v" = (
/obj/structure/fluff/railing/wood{
	dir = 8;
	pixel_y = -1
	},
/obj/structure/fluff/railing/wood,
/turf/open/floor/rogue/cobble,
/area/rogue)
"w" = (
/mob/living/carbon/human/species/goblin/hell,
/obj/effect/mapping_helpers/floor_clothing_equipper,
/obj/item/clothing/under/roguetown/trou/leather/advanced,
/obj/item/clothing/wrists/roguetown/bracers/leather,
/obj/item/rogueweapon/axe/iron,
/turf/open/floor/rogue/cobble,
/area/rogue)
"x" = (
/turf/open/floor/rogue/cobblerock,
/area/rogue)
"y" = (
/obj/structure/fluff/railing/wood{
	dir = 4
	},
/obj/structure/fluff/railing/wood{
	dir = 1
	},
/turf/open/floor/rogue/cobble,
/area/rogue)
"z" = (
/obj/structure/fluff/railing/wood{
	dir = 4
	},
/turf/open/floor/rogue/cobble,
/area/rogue)
"A" = (
/obj/machinery/light/rogue/smelter,
/turf/open/floor/rogue/cobblerock,
/area/rogue)
"E" = (
/mob/living/carbon/human/species/orc/warrior,
/obj/structure/fluff/railing/wood{
	dir = 4
	},
/obj/item/clothing/suit/roguetown/armor/leather/splint,
/obj/item/clothing/under/roguetown/trou/leather/advanced,
/turf/open/floor/rogue/cobble,
/area/rogue)
"G" = (
/obj/structure/fluff/railing/wood{
	dir = 8;
	pixel_y = -1
	},
/turf/open/floor/rogue/cobble,
/area/rogue)
"H" = (
/mob/living/simple_animal/hostile/rogue/orc/orc_marauder/spear,
/turf/open/floor/rogue/cobble,
/area/rogue)
"J" = (
/obj/structure/fluff/railing/wood{
	dir = 8;
	pixel_y = -1
	},
/obj/structure/fluff/railing/wood{
	dir = 1
	},
/turf/open/floor/rogue/cobble,
/area/rogue)
"K" = (
/obj/item/roguebin/water,
/turf/open/floor/rogue/cobblerock,
/area/rogue)
"L" = (
/obj/effect/dungeon_directional_helper/south,
/turf/open/floor/rogue/cobblerock,
/area/rogue)
"M" = (
/obj/machinery/anvil,
/obj/item/riddleofsteel,
/obj/item/rogueweapon/hammer/steel{
	pixel_x = -6;
	pixel_y = 5
	},
/turf/open/floor/rogue/dirt,
/area/rogue)
"N" = (
/turf/open/floor/rogue/dirt,
/area/rogue)
"P" = (
/obj/structure/fluff/railing/wood{
	dir = 1;
	layer = 2.7;
	pixel_x = 2;
	pixel_y = 7
	},
/turf/open/floor/rogue/cobble,
/area/rogue)
"R" = (
/obj/effect/dungeon_directional_helper/west,
/turf/open/floor/rogue/cobblerock,
/area/rogue)
"S" = (
/obj/structure/fluff/railing/wood{
	dir = 1
	},
/turf/open/floor/rogue/cobble,
/area/rogue)
"T" = (
/obj/structure/fluff/railing/wood{
	dir = 8;
	pixel_y = -1
	},
/obj/structure/fluff/railing/wood{
	dir = 1;
	layer = 2.7;
	pixel_x = 2;
	pixel_y = 7
	},
/turf/open/floor/rogue/cobble,
/area/rogue)
"V" = (
/obj/structure/fluff/railing/wood{
	dir = 4
	},
/obj/structure/fluff/railing/wood,
/turf/open/floor/rogue/cobble,
/area/rogue)
"W" = (
/obj/structure/fluff/railing/wood{
	dir = 1;
	layer = 2.7;
	pixel_x = 2;
	pixel_y = 7
	},
/obj/structure/fluff/railing/wood{
	dir = 4
	},
/turf/open/floor/rogue/cobble,
/area/rogue)
"Y" = (
/turf/closed/mineral/rogue/bedrock,
/area/rogue)

(1,1,1) = {"
Y
Y
Y
Y
Y
Y
Y
Y
Y
Y
Y
Y
Y
Y
x
x
R
x
Y
Y
Y
Y
Y
Y
Y
Y
Y
Y
Y
Y
"}
(2,1,1) = {"
Y
Y
Y
Y
Y
Y
x
N
N
N
N
N
x
x
x
x
x
N
N
x
x
x
x
N
Y
Y
Y
Y
Y
Y
"}
(3,1,1) = {"
Y
Y
Y
Y
x
x
N
N
N
N
N
N
N
N
N
N
N
N
N
N
x
x
N
c
N
Y
Y
Y
Y
Y
"}
(4,1,1) = {"
Y
Y
Y
Y
x
N
N
N
N
p
p
N
N
N
x
x
x
x
N
N
N
N
N
N
N
Y
Y
Y
Y
Y
"}
(5,1,1) = {"
Y
Y
Y
x
N
N
N
p
p
p
p
p
p
x
x
x
x
N
N
p
p
p
p
N
N
x
Y
Y
Y
Y
"}
(6,1,1) = {"
Y
Y
N
N
N
p
p
p
p
p
p
p
p
p
p
p
p
p
p
p
p
p
p
p
N
x
x
Y
Y
Y
"}
(7,1,1) = {"
Y
N
N
N
p
p
p
p
p
p
p
p
p
p
p
p
p
p
p
p
p
p
p
p
p
N
x
x
Y
Y
"}
(8,1,1) = {"
Y
N
N
p
p
p
p
b
p
p
p
p
p
p
p
p
p
p
p
p
p
b
p
p
p
N
N
x
x
Y
"}
(9,1,1) = {"
Y
N
N
p
p
p
p
p
N
N
N
p
p
p
p
p
p
p
p
p
N
N
p
p
p
p
N
c
x
Y
"}
(10,1,1) = {"
Y
N
N
p
p
p
p
x
x
x
p
p
p
p
p
p
p
p
p
x
x
N
p
p
p
p
N
N
x
Y
"}
(11,1,1) = {"
Y
N
N
p
p
p
x
N
N
N
p
p
p
p
p
p
p
p
N
x
x
N
p
p
p
p
N
N
N
Y
"}
(12,1,1) = {"
Y
x
N
p
p
p
x
x
x
p
p
p
p
x
u
x
p
p
p
N
N
p
p
p
p
p
N
N
N
Y
"}
(13,1,1) = {"
Y
x
N
N
p
p
p
p
p
p
p
N
N
x
N
x
x
x
p
p
p
p
p
p
p
N
N
N
x
Y
"}
(14,1,1) = {"
x
x
N
N
p
p
p
p
p
p
p
N
u
x
N
N
A
N
p
p
p
p
p
p
p
N
N
x
x
x
"}
(15,1,1) = {"
q
x
N
N
p
p
p
p
p
p
p
x
K
N
M
x
x
N
p
p
p
p
p
p
p
N
N
x
x
x
"}
(16,1,1) = {"
x
x
N
x
p
p
p
p
p
p
p
p
n
x
N
x
A
N
p
p
p
p
p
p
p
N
N
N
x
L
"}
(17,1,1) = {"
x
N
N
x
p
p
p
p
p
p
p
p
p
x
x
x
N
x
p
p
p
p
p
p
p
p
N
N
N
N
"}
(18,1,1) = {"
Y
N
N
x
p
p
p
p
p
p
p
p
p
p
x
x
p
p
p
p
p
p
p
p
p
p
N
N
N
Y
"}
(19,1,1) = {"
Y
x
N
x
p
p
p
p
x
x
p
p
p
p
p
p
p
p
p
p
p
p
p
p
p
p
N
N
N
Y
"}
(20,1,1) = {"
Y
x
N
N
N
p
p
p
x
N
x
N
p
p
p
p
p
N
N
p
p
p
p
p
p
p
p
N
N
Y
"}
(21,1,1) = {"
Y
N
N
N
N
p
p
b
p
N
x
N
p
p
p
p
x
x
x
x
p
b
p
p
p
p
p
N
N
Y
"}
(22,1,1) = {"
Y
Y
N
N
N
N
p
p
p
p
N
N
p
p
p
p
x
x
N
p
p
p
p
p
p
p
N
N
x
Y
"}
(23,1,1) = {"
Y
Y
N
N
c
N
p
p
p
p
p
p
p
p
p
p
p
p
p
p
p
p
p
p
p
N
x
x
Y
Y
"}
(24,1,1) = {"
Y
Y
N
N
N
N
p
p
p
p
p
p
p
p
p
p
p
p
p
p
p
p
p
p
N
x
x
Y
Y
Y
"}
(25,1,1) = {"
Y
Y
Y
N
N
N
N
p
p
p
p
p
p
p
p
p
p
p
p
p
p
p
p
N
N
x
Y
Y
Y
Y
"}
(26,1,1) = {"
Y
Y
Y
Y
N
N
N
N
x
p
p
p
p
p
p
p
p
p
p
p
N
N
N
N
N
N
Y
Y
Y
Y
"}
(27,1,1) = {"
Y
Y
Y
Y
Y
Y
N
x
x
x
x
N
N
p
p
p
p
p
N
N
N
N
c
N
Y
Y
Y
Y
Y
Y
"}
(28,1,1) = {"
Y
Y
Y
Y
Y
Y
Y
Y
x
x
N
N
N
N
N
N
x
x
N
N
N
N
N
Y
Y
Y
Y
Y
Y
Y
"}
(29,1,1) = {"
Y
Y
Y
Y
Y
Y
Y
Y
Y
Y
N
N
N
N
N
x
x
x
x
x
Y
Y
Y
Y
Y
Y
Y
Y
Y
Y
"}
(30,1,1) = {"
Y
Y
Y
Y
Y
Y
Y
Y
Y
Y
Y
Y
Y
Y
Y
N
x
j
x
Y
Y
Y
Y
Y
Y
Y
Y
Y
Y
Y
"}

(1,1,2) = {"
Y
Y
Y
Y
Y
Y
Y
Y
Y
Y
Y
Y
Y
Y
g
g
g
g
Y
Y
Y
Y
Y
Y
Y
Y
Y
Y
Y
Y
"}
(2,1,2) = {"
Y
Y
Y
Y
Y
Y
a
a
a
a
a
a
a
a
g
g
g
g
a
a
a
a
a
a
Y
Y
Y
Y
Y
Y
"}
(3,1,2) = {"
Y
Y
Y
Y
a
a
a
a
a
a
a
a
a
a
a
P
m
a
a
a
a
a
a
a
a
Y
Y
Y
Y
Y
"}
(4,1,2) = {"
Y
Y
Y
Y
a
a
a
a
a
a
a
a
a
a
a
P
m
a
a
a
a
a
a
a
a
Y
Y
Y
Y
Y
"}
(5,1,2) = {"
Y
Y
Y
a
a
a
a
a
a
a
a
a
a
a
a
P
m
a
a
a
a
a
a
a
a
a
Y
Y
Y
Y
"}
(6,1,2) = {"
Y
Y
a
a
a
a
a
a
a
a
a
a
a
a
T
w
g
v
a
a
a
a
a
a
a
a
a
Y
Y
Y
"}
(7,1,2) = {"
Y
a
a
a
a
a
a
T
G
G
G
G
G
G
g
g
g
g
G
G
G
v
a
a
a
a
a
a
Y
Y
"}
(8,1,2) = {"
Y
a
a
a
a
a
T
g
g
z
z
z
z
z
z
z
E
z
z
z
g
g
v
a
a
a
a
a
a
Y
"}
(9,1,2) = {"
Y
a
a
a
a
a
P
g
V
a
a
a
a
a
a
a
a
a
a
a
y
g
m
a
a
a
a
a
a
Y
"}
(10,1,2) = {"
Y
a
a
a
a
a
P
m
a
a
a
a
a
a
a
a
a
a
a
a
a
S
m
a
a
a
a
a
a
Y
"}
(11,1,2) = {"
Y
a
a
a
a
a
P
m
a
a
a
a
a
a
a
a
a
a
a
a
a
S
m
a
a
a
a
a
a
Y
"}
(12,1,2) = {"
Y
a
a
a
a
a
P
m
a
a
a
a
a
a
a
a
a
a
a
a
a
S
m
a
a
a
a
a
a
Y
"}
(13,1,2) = {"
Y
a
a
a
a
a
P
m
a
a
a
a
a
a
a
a
a
a
a
a
a
S
m
a
a
a
a
a
a
Y
"}
(14,1,2) = {"
g
g
a
a
a
T
g
m
a
a
a
a
a
a
a
a
a
a
a
a
a
S
g
v
a
a
a
a
g
g
"}
(15,1,2) = {"
g
g
G
G
G
g
g
m
a
a
a
a
a
a
a
a
a
a
a
a
a
S
g
g
G
G
G
g
g
g
"}
(16,1,2) = {"
g
g
z
z
z
g
f
m
a
a
a
a
a
a
a
a
a
a
a
a
a
S
w
g
z
z
z
g
g
g
"}
(17,1,2) = {"
g
g
a
a
a
W
g
m
a
a
a
a
a
a
a
a
a
a
a
a
a
S
g
V
a
a
a
a
g
g
"}
(18,1,2) = {"
Y
a
a
a
a
a
P
m
a
a
a
a
a
a
a
a
a
a
a
a
a
S
m
a
a
a
a
a
a
Y
"}
(19,1,2) = {"
Y
a
a
a
a
a
P
m
a
a
a
a
a
a
a
a
a
a
a
a
a
S
m
a
a
a
a
a
a
Y
"}
(20,1,2) = {"
Y
a
a
a
a
a
P
g
v
a
a
a
a
a
a
a
a
a
a
a
J
g
m
a
a
a
a
a
a
Y
"}
(21,1,2) = {"
Y
a
a
a
a
a
W
g
g
G
G
G
G
G
G
G
G
G
G
G
g
g
V
a
a
a
a
a
a
Y
"}
(22,1,2) = {"
Y
Y
a
a
a
a
a
o
z
z
z
z
z
z
z
g
g
H
g
z
z
V
a
a
a
a
a
a
a
Y
"}
(23,1,2) = {"
Y
Y
a
a
a
a
a
a
a
a
a
a
a
a
a
y
g
g
V
a
a
a
a
a
a
a
a
a
Y
Y
"}
(24,1,2) = {"
Y
Y
a
a
a
a
a
a
a
a
a
a
a
a
a
a
S
m
a
a
a
a
a
a
a
a
a
Y
Y
Y
"}
(25,1,2) = {"
Y
Y
Y
a
a
a
a
a
a
a
a
a
a
a
a
a
S
m
a
a
a
a
a
a
a
a
Y
Y
Y
Y
"}
(26,1,2) = {"
Y
Y
Y
Y
a
a
a
a
a
a
a
a
a
a
a
a
S
m
a
a
a
a
a
a
a
a
Y
Y
Y
Y
"}
(27,1,2) = {"
Y
Y
Y
Y
Y
Y
a
a
a
a
a
a
a
a
a
a
S
m
a
a
a
a
d
a
Y
Y
Y
Y
Y
Y
"}
(28,1,2) = {"
Y
Y
Y
Y
Y
Y
Y
Y
a
a
a
a
a
a
a
a
g
g
a
a
a
a
a
Y
Y
Y
Y
Y
Y
Y
"}
(29,1,2) = {"
Y
Y
Y
Y
Y
Y
Y
Y
Y
Y
a
a
a
a
a
g
g
g
g
a
Y
Y
Y
Y
Y
Y
Y
Y
Y
Y
"}
(30,1,2) = {"
Y
Y
Y
Y
Y
Y
Y
Y
Y
Y
Y
Y
Y
Y
Y
g
g
g
g
Y
Y
Y
Y
Y
Y
Y
Y
Y
Y
Y
"}
