//MAP CONVERTED BY dmm2tgm.py THIS HEADER COMMENT PREVENTS RECONVERSION, DO NOT REMOVE
"aL" = (
/obj/structure/fluff/railing/border{
	dir = 1
	},
/obj/structure/table/wood/plain_alt,
/obj/item/reagent_containers/food/snacks/rotten/breadslice{
	pixel_y = -2;
	pixel_x = -13
	},
/turf/open/floor/wood,
/area/rogue/under/cave)
"bN" = (
/obj/structure/chair/bench/church/mid,
/turf/open/floor/carpet/lord/center,
/area/rogue/under/cave)
"eB" = (
/obj/structure/fluff/railing/border{
	dir = 1
	},
/turf/open/floor/wood,
/area/rogue/under/cave)
"hk" = (
/obj/structure/fluff/walldeco/bigpainting,
/turf/open/transparent/openspace,
/area/rogue/under/cave)
"hn" = (
/obj/structure/fluff/railing/border{
	dir = 5
	},
/turf/open/floor/wood,
/area/rogue/under/cave)
"hZ" = (
/obj/structure/mineral_door/wood/deadbolt{
	dir = 8;
	locked = 1
	},
/turf/open/floor/hexstone,
/area/rogue/under/cave)
"iw" = (
/obj/structure/chair/bench/church/mid,
/obj/structure/chair/bench/church/mid,
/turf/open/floor/carpet/lord/center,
/area/rogue/under/cave)
"kB" = (
/obj/structure/chair/wood/alt/chair_noble/red{
	dir = 8
	},
/turf/open/floor/wood,
/area/rogue/under/cave)
"lg" = (
/turf/open/floor/hexstone,
/area/rogue/under/cave)
"ms" = (
/obj/structure/mineral_door/wood/deadbolt{
	locked = 1
	},
/turf/open/floor/hexstone,
/area/rogue/under/cave)
"oQ" = (
/obj/effect/dungeon_directional_helper/north,
/turf/open/floor/cobblerock,
/area/rogue/under/cave)
"qt" = (
/turf/open/floor/hexstone{
	dir = 1
	},
/area/rogue/under/cave)
"rp" = (
/obj/structure/mineral_door/wood/deadbolt{
	dir = 4;
	locked = 1
	},
/turf/open/floor/hexstone,
/area/rogue/under/cave)
"sE" = (
/obj/structure/fluff/walldeco/painting/castle,
/turf/closed/wall/mineral/stone,
/area/rogue/under/cave)
"tj" = (
/obj/structure/table/church,
/obj/item/reagent_containers/glass/cup/golden{
	pixel_x = -6;
	pixel_y = 14
	},
/obj/item/gem/blue{
	pixel_y = 7;
	pixel_x = 5
	},
/turf/open/floor/hexstone,
/area/rogue/under/cave)
"vb" = (
/obj/structure/table/vtable/v2,
/obj/item/statue/gold{
	pixel_y = 14
	},
/turf/open/floor/hexstone,
/area/rogue/under/cave)
"vj" = (
/obj/structure/mineral_door/wood/deadbolt{
	dir = 1;
	locked = 1
	},
/turf/open/floor/hexstone,
/area/rogue/under/cave)
"vv" = (
/obj/structure/table/church,
/obj/structure/table/church/m,
/obj/item/clothing/ring/active/nomag{
	pixel_x = 23;
	pixel_y = 6
	},
/obj/item/weapon/sword/decorated{
	name = "A Lords Blade";
	desc = "A long dead kings Blade, Forgotten to time yet master in work."
	},
/turf/open/floor/hexstone,
/area/rogue/under/cave)
"wo" = (
/obj/structure/fluff/railing/border{
	dir = 10
	},
/turf/open/floor/wood,
/area/rogue/under/cave)
"yY" = (
/obj/structure/fluff/railing/border{
	dir = 4
	},
/turf/open/floor/wood,
/area/rogue/under/cave)
"zk" = (
/obj/structure/fluff/railing/border{
	dir = 1
	},
/obj/structure/table/wood/plain_alt,
/obj/item/reagent_containers/food/snacks/rotten/breadslice{
	pixel_x = 19
	},
/obj/item/weapon/knife/cleaver{
	pixel_x = -2;
	pixel_y = -8
	},
/turf/open/floor/wood,
/area/rogue/under/cave)
"zw" = (
/obj/structure/fluff/railing/border{
	dir = 8
	},
/turf/open/floor/wood,
/area/rogue/under/cave)
"Ab" = (
/obj/item/reagent_containers/food/snacks/smallrat,
/turf/open/floor/wood,
/area/rogue/under/cave)
"BU" = (
/turf/open/transparent/openspace,
/area/rogue/under/cave)
"Cf" = (
/obj/structure/fluff/railing/border,
/turf/open/floor/wood,
/area/rogue/under/cave)
"CC" = (
/obj/structure/chair/bench/church/r,
/mob/living/carbon/human/species/skeleton/npc/warrior,
/turf/open/floor/carpet/lord/right,
/area/rogue/under/cave)
"CT" = (
/obj/structure/closet/crate/crafted_closet/inn/chest,
/obj/item/clothing/shirt/robe/black,
/obj/item/clothing/shirt/robe/mage,
/turf/open/floor/wood,
/area/rogue/under/cave)
"DK" = (
/turf/closed/mineral/bedrock,
/area/rogue/under/cave)
"EZ" = (
/obj/structure/fluff/railing/border{
	dir = 6
	},
/obj/item/reagent_containers/food/snacks/smallrat,
/turf/open/floor/wood,
/area/rogue/under/cave)
"FB" = (
/obj/structure/fluff/walldeco/painting/skull,
/turf/closed/wall/mineral/stone,
/area/rogue/under/cave)
"GG" = (
/obj/structure/fluff/walldeco/bigpainting,
/turf/open/floor/hexstone,
/area/rogue/under/cave)
"Hm" = (
/obj/structure/fluff/walldeco/bigpainting/lake,
/turf/open/transparent/openspace,
/area/rogue/under/cave)
"HK" = (
/obj/structure/fluff/walldeco/painting/skull,
/turf/closed/wall/mineral/stone/moss,
/area/rogue/under/cave)
"Ip" = (
/obj/machinery/light/fueled/chand,
/turf/open/transparent/openspace,
/area/rogue/under/cave)
"JM" = (
/obj/structure/chair/wood/alt/chair_noble/red,
/turf/open/floor/wood,
/area/rogue/under/cave)
"KU" = (
/obj/structure/mineral_door/wood/deadbolt{
	dir = 1;
	locked = 1
	},
/turf/open/floor/hexstone{
	dir = 1
	},
/area/rogue/under/cave)
"Ll" = (
/obj/effect/dungeon_directional_helper/east,
/turf/open/floor/cobblerock,
/area/rogue/under/cave)
"Ls" = (
/obj/structure/chair/bench/church,
/turf/open/floor/carpet/lord/left,
/area/rogue/under/cave)
"LH" = (
/obj/structure/fluff/walldeco/painting/crown,
/turf/closed/wall/mineral/stone/moss,
/area/rogue/under/cave)
"Ob" = (
/obj/structure/chair/bench/church/mid,
/mob/living/carbon/human/species/skeleton/npc/warrior,
/turf/open/floor/carpet/lord/center,
/area/rogue/under/cave)
"Oc" = (
/obj/item/ingot/gold,
/obj/item/ingot/gold{
	pixel_x = 9;
	pixel_y = -4
	},
/obj/item/ingot/gold{
	pixel_y = 4;
	pixel_x = 5
	},
/turf/open/floor/hexstone,
/area/rogue/under/cave)
"Ox" = (
/turf/open/floor/wood,
/area/rogue/under/cave)
"OA" = (
/obj/effect/dungeon_directional_helper/west,
/turf/open/floor/cobblerock,
/area/rogue/under/cave)
"QC" = (
/obj/structure/fluff/railing/border{
	dir = 9
	},
/turf/open/floor/wood,
/area/rogue/under/cave)
"Rn" = (
/obj/structure/chair/bench/church/r,
/turf/open/floor/carpet/lord/right,
/area/rogue/under/cave)
"RJ" = (
/turf/closed/wall/mineral/stone,
/area/rogue/under/cave)
"RZ" = (
/turf/open/floor/cobblerock,
/area/rogue/under/cave)
"Tf" = (
/turf/closed/wall/mineral/stone/moss,
/area/rogue/under/cave)
"TG" = (
/obj/structure/table/wood/plain_alt,
/turf/open/floor/wood,
/area/rogue/under/cave)
"UK" = (
/obj/structure/chair/bench/throne,
/obj/item/reagent_containers/glass/bottle/redwine{
	pixel_x = -19
	},
/obj/item/reagent_containers/glass/bottle/redwine{
	pixel_x = 16;
	pixel_y = -11
	},
/obj/item/reagent_containers/glass/bottle/redwine{
	pixel_y = -13;
	pixel_x = -9
	},
/mob/living/carbon/human/species/skeleton/npc/warrior/skilled{
	name = "Wine Drenched Skeleton"
	},
/turf/open/floor/hexstone,
/area/rogue/under/cave)
"VG" = (
/obj/effect/dungeon_directional_helper/south,
/turf/open/floor/cobblerock,
/area/rogue/under/cave)
"Wp" = (
/obj/structure/table/vtable,
/obj/item/statue/gold/loot{
	pixel_y = 11
	},
/turf/open/floor/hexstone,
/area/rogue/under/cave)
"WG" = (
/obj/structure/fluff/walldeco/painting,
/turf/closed/wall/mineral/stone/moss,
/area/rogue/under/cave)
"Xm" = (
/obj/structure/table/church{
	dir = 1
	},
/turf/open/floor/hexstone,
/area/rogue/under/cave)
"Yw" = (
/obj/structure/chair/bench/church,
/mob/living/carbon/human/species/skeleton/npc/warrior,
/turf/open/floor/carpet/lord/left,
/area/rogue/under/cave)
"YM" = (
/obj/structure/fluff/railing/border{
	dir = 1
	},
/obj/structure/table/wood/plain_alt,
/obj/structure/table/wood/plain_alt,
/obj/item/reagent_containers/glass/bottle/wine/sourwine,
/turf/open/floor/wood,
/area/rogue/under/cave)
"ZE" = (
/obj/structure/mirror/fancy,
/turf/open/floor/hexstone,
/area/rogue/under/cave)

(1,1,1) = {"
DK
DK
DK
DK
DK
RZ
RZ
OA
RZ
DK
DK
DK
DK
DK
DK
"}
(2,1,1) = {"
DK
Tf
Tf
RJ
RJ
RJ
rp
rp
Tf
RJ
Tf
Tf
Tf
Tf
DK
"}
(3,1,1) = {"
DK
Tf
lg
lg
lg
lg
lg
lg
lg
lg
lg
lg
lg
Tf
DK
"}
(4,1,1) = {"
DK
RJ
GG
lg
lg
Ls
Ls
Ls
Ls
Yw
Ls
lg
lg
Tf
DK
"}
(5,1,1) = {"
DK
RJ
Wp
lg
lg
Ob
iw
bN
bN
bN
bN
lg
lg
Tf
DK
"}
(6,1,1) = {"
DK
RJ
vb
lg
lg
Rn
Rn
CC
Rn
Rn
Rn
lg
lg
RJ
DK
"}
(7,1,1) = {"
RZ
ms
lg
lg
tj
lg
lg
lg
lg
lg
lg
lg
lg
Tf
RZ
"}
(8,1,1) = {"
oQ
FB
UK
lg
vv
lg
lg
lg
lg
qt
lg
lg
lg
vj
VG
"}
(9,1,1) = {"
RZ
ms
lg
lg
Xm
lg
lg
lg
lg
lg
lg
lg
lg
Tf
RZ
"}
(10,1,1) = {"
DK
Tf
Oc
lg
lg
Ls
Ls
Ls
Yw
Ls
Ls
lg
lg
Tf
DK
"}
(11,1,1) = {"
DK
Tf
lg
lg
lg
Ob
bN
bN
bN
bN
bN
lg
lg
RJ
DK
"}
(12,1,1) = {"
DK
sE
lg
lg
lg
Rn
Rn
CC
Rn
Rn
CC
lg
lg
Tf
DK
"}
(13,1,1) = {"
DK
Tf
ZE
lg
lg
lg
lg
lg
lg
lg
lg
lg
lg
Tf
DK
"}
(14,1,1) = {"
DK
Tf
Tf
RJ
RJ
Tf
hZ
hZ
Tf
Tf
WG
RJ
Tf
Tf
DK
"}
(15,1,1) = {"
DK
DK
DK
DK
DK
RZ
RZ
Ll
RZ
DK
DK
DK
DK
DK
DK
"}

(1,1,2) = {"
DK
DK
DK
DK
DK
qt
qt
qt
qt
DK
DK
DK
DK
DK
DK
"}
(2,1,2) = {"
DK
Tf
Tf
Tf
Tf
Tf
rp
rp
Tf
Tf
Tf
LH
Tf
Tf
DK
"}
(3,1,2) = {"
DK
Tf
BU
BU
BU
Ox
Ox
Ox
Ox
Ox
Ox
JM
TG
Tf
DK
"}
(4,1,2) = {"
DK
Tf
Hm
BU
BU
Ox
Ox
Ox
Ox
Ox
Ox
Ox
kB
Tf
DK
"}
(5,1,2) = {"
DK
Tf
BU
BU
BU
yY
yY
hn
EZ
yY
yY
hn
Ox
Tf
DK
"}
(6,1,2) = {"
DK
Tf
BU
BU
BU
BU
BU
eB
Cf
BU
BU
eB
Ox
Tf
DK
"}
(7,1,2) = {"
qt
ms
zw
BU
BU
BU
BU
BU
BU
BU
BU
zk
Ox
KU
qt
"}
(8,1,2) = {"
qt
Tf
Ox
BU
Ip
BU
Ip
BU
Ip
BU
BU
YM
Ox
Tf
qt
"}
(9,1,2) = {"
qt
ms
yY
BU
BU
BU
BU
BU
BU
BU
BU
aL
Ox
KU
qt
"}
(10,1,2) = {"
DK
Tf
BU
BU
BU
BU
BU
eB
Cf
BU
BU
eB
Ox
Tf
DK
"}
(11,1,2) = {"
DK
Tf
hk
BU
BU
zw
zw
QC
wo
zw
zw
QC
Ox
Tf
DK
"}
(12,1,2) = {"
DK
Tf
BU
BU
BU
Ox
Ox
Ox
Ab
Ox
Ox
Ox
Ox
Tf
DK
"}
(13,1,2) = {"
DK
Tf
BU
BU
BU
Ox
Ox
Ox
Ox
Ox
CT
CT
CT
Tf
DK
"}
(14,1,2) = {"
DK
Tf
Tf
Tf
Tf
Tf
hZ
hZ
Tf
Tf
HK
Tf
Tf
Tf
DK
"}
(15,1,2) = {"
DK
DK
DK
DK
DK
qt
qt
qt
qt
DK
DK
DK
DK
DK
DK
"}
