//MAP CONVERTED BY dmm2tgm.py THIS HEADER COMMENT PREVENTS RECONVERSION, DO NOT REMOVE
"a" = (
/turf/closed/mineral/rogue/bedrock,
/area/rogue)
"c" = (
/obj/item/clothing/suit/roguetown/armor/cuirass/iron,
/turf/open/floor/rogue/naturalstone,
/area/rogue)
"e" = (
/obj/effect/dungeon_directional_helper/south,
/turf/open/floor/rogue/naturalstone,
/area/rogue)
"g" = (
/obj/item/clothing/head/roguetown/helmet/ironpot,
/turf/open/floor/rogue/naturalstone,
/area/rogue)
"i" = (
/mob/living/carbon/human/species/skeleton,
/obj/effect/landmark/chest_or_mimic,
/obj/item/roguecoin/copper/pile,
/turf/open/floor/rogue/naturalstone,
/area/rogue)
"k" = (
/obj/item/clothing/suit/roguetown/armor/chainmail/iron,
/turf/open/floor/rogue/naturalstone,
/area/rogue)
"l" = (
/obj/effect/landmark/chest_or_mimic,
/obj/item/roguecoin/copper/pile,
/obj/item/clothing/head/roguetown/helmet/nasal,
/turf/open/floor/rogue/naturalstone,
/area/rogue)
"m" = (
/obj/effect/landmark/chest_or_mimic,
/obj/item/roguecoin/copper/pile,
/turf/open/floor/rogue/naturalstone,
/area/rogue)
"n" = (
/obj/effect/landmark/chest_or_mimic,
/obj/item/roguecoin/copper/pile,
/obj/item/clothing/ring/silver,
/turf/open/floor/rogue/naturalstone,
/area/rogue)
"o" = (
/obj/item/clothing/head/roguetown/helmet/bascinet,
/turf/open/floor/rogue/naturalstone,
/area/rogue)
"p" = (
/obj/item/clothing/suit/roguetown/armor/medium/scale,
/obj/item/rogueweapon/polearm/spear,
/turf/open/floor/rogue/naturalstone,
/area/rogue)
"q" = (
/obj/item/clothing/head/roguetown/helmet/winged,
/turf/open/floor/rogue/naturalstone,
/area/rogue)
"r" = (
/obj/item/clothing/suit/roguetown/armor/gambeson/arming,
/turf/open/floor/rogue/naturalstone,
/area/rogue)
"s" = (
/obj/effect/landmark/chest_or_mimic,
/obj/item/roguecoin/copper/pile,
/obj/item/clothing/gloves/roguetown/plate,
/turf/open/floor/rogue/naturalstone,
/area/rogue)
"t" = (
/obj/structure/stairs/stone{
	dir = 1
	},
/turf/open/floor/rogue/naturalstone,
/area/rogue)
"u" = (
/obj/effect/dungeon_directional_helper/north,
/turf/open/floor/rogue/naturalstone,
/area/rogue)
"w" = (
/turf/open/floor/rogue/naturalstone,
/area/rogue)
"x" = (
/turf/open/transparent/openspace,
/area/rogue)
"y" = (
/mob/living/carbon/human/species/skeleton/npc,
/turf/open/floor/rogue/naturalstone,
/area/rogue)
"z" = (
/obj/structure/stairs/stone{
	dir = 4
	},
/turf/open/floor/rogue/naturalstone,
/area/rogue)
"A" = (
/obj/effect/dungeon_directional_helper/east,
/turf/open/floor/rogue/naturalstone,
/area/rogue)
"B" = (
/mob/living/carbon/human/species/skeleton/npc/warrior/skilled,
/obj/effect/landmark/chest_or_mimic,
/obj/item/roguecoin/copper/pile,
/obj/item/clothing/ring/silver/rontz,
/turf/open/floor/rogue/naturalstone,
/area/rogue)
"C" = (
/obj/item/clothing/shoes/roguetown/boots/armor,
/turf/open/floor/rogue/naturalstone,
/area/rogue)
"D" = (
/obj/structure/stairs/stone,
/turf/open/floor/rogue/naturalstone,
/area/rogue)
"G" = (
/obj/item/clothing/head/roguetown/helmet/skullcap,
/turf/open/floor/rogue/naturalstone,
/area/rogue)
"H" = (
/obj/effect/landmark/chest_or_mimic,
/obj/item/roguecoin/copper/pile,
/obj/item/lockpickring,
/obj/item/clothing/head/roguetown/helmet/leather/volfhelm,
/turf/open/floor/rogue/naturalstone,
/area/rogue)
"I" = (
/obj/item/rogueweapon/polearm/spear,
/turf/open/floor/rogue/naturalstone,
/area/rogue)
"M" = (
/obj/item/rogueweapon/sword/iron,
/turf/open/floor/rogue/naturalstone,
/area/rogue)
"P" = (
/obj/item/clothing/suit/roguetown/armor/cuirass/iron/rust,
/turf/open/floor/rogue/naturalstone,
/area/rogue)
"Q" = (
/obj/item/rogueweapon/polearm/spear,
/mob/living/carbon/human/species/skeleton/npc,
/turf/open/floor/rogue/naturalstone,
/area/rogue)
"R" = (
/mob/living/simple_animal/hostile/rogue/skeleton/bow,
/turf/open/floor/rogue/naturalstone,
/area/rogue)
"S" = (
/obj/effect/dungeon_directional_helper/west,
/turf/open/floor/rogue/naturalstone,
/area/rogue)
"U" = (
/obj/item/clothing/suit/roguetown/armor/leather/hide,
/turf/open/floor/rogue/naturalstone,
/area/rogue)
"X" = (
/obj/item/clothing/suit/roguetown/armor/gambeson,
/turf/open/floor/rogue/naturalstone,
/area/rogue)
"Y" = (
/obj/structure/stairs/stone{
	dir = 8
	},
/turf/open/floor/rogue/naturalstone,
/area/rogue)
"Z" = (
/obj/item/clothing/suit/roguetown/armor/cuirass/grenzelhoft,
/turf/open/floor/rogue/naturalstone,
/area/rogue)

(1,1,1) = {"
a
a
a
a
a
a
a
t
w
S
w
D
a
a
a
a
a
a
a
a
"}
(2,1,1) = {"
a
a
a
a
a
a
a
t
w
w
w
D
a
a
a
a
a
a
a
a
"}
(3,1,1) = {"
a
a
a
a
a
a
a
a
a
a
a
a
a
a
a
a
a
a
a
a
"}
(4,1,1) = {"
a
a
a
a
a
a
w
w
w
w
w
w
w
w
a
a
a
a
a
a
"}
(5,1,1) = {"
a
a
a
a
a
w
w
w
w
w
Z
w
M
w
w
w
a
a
a
a
"}
(6,1,1) = {"
a
a
a
a
w
w
w
w
I
U
w
w
w
w
w
w
a
a
a
a
"}
(7,1,1) = {"
a
a
a
w
w
w
X
M
y
w
w
w
y
o
w
w
w
a
a
a
"}
(8,1,1) = {"
Y
Y
a
w
w
w
Q
w
o
C
y
w
w
M
k
I
w
a
Y
Y
"}
(9,1,1) = {"
w
w
a
w
w
w
G
w
w
i
m
n
w
g
w
w
w
a
w
w
"}
(10,1,1) = {"
u
w
a
w
y
w
P
w
c
m
B
s
y
w
w
y
w
a
w
e
"}
(11,1,1) = {"
w
w
a
w
w
w
y
w
w
H
l
m
w
w
w
w
w
a
w
w
"}
(12,1,1) = {"
w
w
a
w
w
w
w
p
y
w
y
w
w
y
w
w
w
a
w
w
"}
(13,1,1) = {"
z
z
a
w
w
w
w
w
w
w
w
w
w
w
w
w
r
a
z
z
"}
(14,1,1) = {"
a
a
a
a
w
w
w
w
w
I
q
w
c
w
I
w
w
a
a
a
"}
(15,1,1) = {"
a
a
a
a
w
w
M
y
w
w
w
y
o
w
w
w
a
a
a
a
"}
(16,1,1) = {"
a
a
a
a
a
w
w
w
w
M
w
w
I
w
M
a
a
a
a
a
"}
(17,1,1) = {"
a
a
a
a
a
a
w
w
w
w
w
w
w
a
a
a
a
a
a
a
"}
(18,1,1) = {"
a
a
a
a
a
a
a
a
a
a
a
a
a
a
a
a
a
a
a
a
"}
(19,1,1) = {"
a
a
a
a
a
a
a
t
w
w
w
D
a
a
a
a
a
a
a
a
"}
(20,1,1) = {"
a
a
a
a
a
a
a
t
w
A
w
D
a
a
a
a
a
a
a
a
"}

(1,1,2) = {"
a
a
a
a
w
w
t
x
x
w
x
x
D
w
a
a
a
a
a
a
"}
(2,1,2) = {"
a
a
a
w
w
w
t
x
x
w
x
x
D
w
w
w
w
a
a
a
"}
(3,1,2) = {"
a
a
w
w
w
w
w
w
w
w
w
w
w
w
w
w
w
w
a
a
"}
(4,1,2) = {"
a
a
w
w
w
w
x
x
x
w
x
x
x
x
w
w
w
w
a
a
"}
(5,1,2) = {"
a
w
w
w
w
x
x
x
x
w
x
x
x
x
x
x
w
w
w
a
"}
(6,1,2) = {"
w
w
w
w
x
x
x
x
x
w
x
x
x
x
x
x
w
w
w
w
"}
(7,1,2) = {"
Y
Y
w
x
x
x
x
x
x
w
x
x
x
x
x
x
x
w
Y
Y
"}
(8,1,2) = {"
x
x
w
x
x
x
x
x
x
w
x
x
x
x
x
x
x
w
x
x
"}
(9,1,2) = {"
x
x
w
x
x
x
x
x
x
R
x
x
x
x
x
x
x
w
x
x
"}
(10,1,2) = {"
w
w
w
w
w
w
w
w
w
w
w
R
w
w
w
w
w
w
w
w
"}
(11,1,2) = {"
w
w
w
w
w
w
w
R
w
w
w
w
w
w
w
w
w
w
w
w
"}
(12,1,2) = {"
x
x
w
x
x
x
x
x
x
R
x
x
x
x
x
x
x
w
x
x
"}
(13,1,2) = {"
x
x
w
x
x
x
x
x
x
w
x
x
x
x
x
x
x
w
x
x
"}
(14,1,2) = {"
z
z
w
w
x
x
x
x
x
w
x
x
x
x
x
x
x
w
z
z
"}
(15,1,2) = {"
w
w
w
w
x
x
x
x
x
w
x
x
x
x
x
x
w
w
w
w
"}
(16,1,2) = {"
a
w
w
w
w
x
x
x
x
w
x
x
x
x
x
w
w
w
w
a
"}
(17,1,2) = {"
a
a
w
w
w
w
x
x
x
w
x
x
x
w
w
w
w
w
a
a
"}
(18,1,2) = {"
a
a
a
w
w
w
w
w
w
w
w
w
w
w
w
w
w
a
a
a
"}
(19,1,2) = {"
a
a
a
a
w
w
t
x
x
w
x
x
D
w
w
w
a
a
a
a
"}
(20,1,2) = {"
a
a
a
a
a
w
t
x
x
w
x
x
D
w
w
a
a
a
a
a
"}
