//MAP CONVERTED BY dmm2tgm.py THIS HEADER COMMENT PREVENTS RECONVERSION, DO NOT REMOVE
"av" = (
/turf/closed/mineral/bedrock,
/area/rogue/under/cave)
"aF" = (
/obj/structure/table/wood/plain,
/turf/open/floor/herringbone,
/area/rogue/indoors/shelter)
"bP" = (
/obj/structure/mineral_door/wood,
/turf/open/floor/herringbone,
/area/rogue/indoors/shelter)
"cG" = (
/turf/open/floor/carpet/red,
/area/rogue/indoors/shelter)
"ed" = (
/obj/structure/stairs/stone/church{
	dir = 1
	},
/turf/open/floor/hexstone,
/area/rogue/indoors/shelter)
"et" = (
/turf/closed/wall/mineral/stone,
/area/rogue/indoors/shelter)
"gw" = (
/turf/open/floor/hexstone,
/area/rogue/indoors/shelter)
"hV" = (
/obj/structure/table/church{
	dir = 1
	},
/obj/item/reagent_containers/food/snacks/hardtack{
	pixel_x = 8;
	pixel_y = 12
	},
/obj/item/reagent_containers/food/snacks/hardtack{
	pixel_x = 2;
	pixel_y = 4
	},
/obj/item/reagent_containers/food/snacks/hardtack{
	pixel_x = -7;
	pixel_y = 11
	},
/turf/open/floor/hexstone,
/area/rogue/indoors/shelter)
"kf" = (
/obj/structure/closet/crate/chest,
/obj/item/neuFarm/seed/wheat,
/obj/item/neuFarm/seed/wheat,
/obj/item/neuFarm/seed/wheat,
/obj/item/neuFarm/seed/wheat,
/obj/item/neuFarm/seed/wheat,
/obj/item/neuFarm/seed/wheat,
/obj/item/neuFarm/seed/wheat,
/obj/item/weapon/hoe,
/obj/item/weapon/sickle,
/obj/item/weapon/thresher,
/obj/item/neuFarm/seed/onion,
/obj/item/neuFarm/seed/onion,
/obj/item/neuFarm/seed/onion,
/obj/item/neuFarm/seed/onion,
/obj/item/neuFarm/seed/onion,
/obj/item/neuFarm/seed/onion,
/obj/item/neuFarm/seed/cabbage,
/obj/item/neuFarm/seed/cabbage,
/obj/item/neuFarm/seed/cabbage,
/obj/item/neuFarm/seed/cabbage,
/obj/item/neuFarm/seed/apple,
/obj/item/neuFarm/seed/apple,
/obj/item/neuFarm/seed/apple,
/turf/open/floor/dirt,
/area/rogue/under/cave)
"kW" = (
/turf/open/floor/dirt,
/area/rogue/under/cave)
"ma" = (
/obj/effect/decal/cleanable/sigil/S,
/turf/open/floor/hexstone,
/area/rogue/indoors/shelter)
"md" = (
/obj/structure/dungeon_exit,
/turf/open/floor/herringbone,
/area/rogue/indoors/shelter)
"ny" = (
/obj/structure/fermentation_keg/random/water,
/turf/open/floor/herringbone,
/area/rogue/indoors/shelter)
"nK" = (
/obj/machinery/light/fueled/oven/east,
/turf/open/floor/herringbone,
/area/rogue/indoors/shelter)
"os" = (
/obj/structure/stairs/stone/church{
	dir = 1
	},
/turf/open/floor/herringbone,
/area/rogue/indoors/shelter)
"pd" = (
/turf/closed/wall/mineral/stone/window,
/area/rogue/indoors/shelter)
"pI" = (
/obj/machinery/light/fueled/torchholder/c,
/turf/open/floor/herringbone,
/area/rogue/indoors/shelter)
"qs" = (
/obj/structure/table/wood/plain,
/obj/item/weapon/knife/cleaver,
/turf/open/floor/herringbone,
/area/rogue/indoors/shelter)
"ry" = (
/obj/structure/closet/crate/chest,
/obj/item/reagent_containers/food/snacks/produce/wheat,
/obj/item/reagent_containers/food/snacks/produce/wheat,
/obj/item/reagent_containers/food/snacks/produce/wheat,
/obj/item/reagent_containers/food/snacks/produce/wheat,
/obj/item/reagent_containers/food/snacks/produce/wheat,
/obj/item/reagent_containers/food/snacks/produce/wheat,
/obj/item/reagent_containers/food/snacks/produce/wheat,
/obj/item/reagent_containers/food/snacks/produce/wheat,
/obj/item/reagent_containers/food/snacks/produce/wheat,
/turf/open/floor/herringbone,
/area/rogue/indoors/shelter)
"sj" = (
/obj/item/reagent_containers/glass/bucket/wooden/alter,
/turf/open/floor/dirt,
/area/rogue/under/cave)
"tz" = (
/obj/structure/fluff/statue/knightalt,
/turf/open/floor/hexstone,
/area/rogue/indoors/shelter)
"uG" = (
/obj/structure/table/church/m,
/obj/item/reagent_containers/glass/bottle/waterskin{
	pixel_y = -1;
	pixel_x = -5
	},
/obj/item/reagent_containers/glass/bottle/waterskin{
	pixel_y = 3
	},
/obj/item/reagent_containers/glass/bottle/waterskin{
	pixel_x = 8;
	pixel_y = 7
	},
/turf/open/floor/hexstone,
/area/rogue/indoors/shelter)
"uW" = (
/obj/structure/well,
/turf/open/floor/dirt,
/area/rogue/under/cave)
"wx" = (
/obj/structure/fermentation_keg/random/beer,
/turf/open/floor/herringbone,
/area/rogue/indoors/shelter)
"xk" = (
/obj/effect/dungeon_directional_helper/south,
/turf/open/floor/naturalstone,
/area/rogue/under/cave)
"xl" = (
/turf/open/floor/naturalstone,
/area/rogue/under/cave)
"xP" = (
/turf/open/floor/hexstone,
/area/rogue/under/cave)
"yl" = (
/obj/effect/decal/cleanable/sigil,
/obj/effect/decal/cleanable/blood,
/turf/open/floor/hexstone,
/area/rogue/indoors/shelter)
"Ac" = (
/obj/structure/fluff/statue/knight/interior,
/turf/open/floor/hexstone,
/area/rogue/indoors/shelter)
"AB" = (
/turf/open/transparent/openspace,
/area/rogue/under/cave)
"AC" = (
/obj/structure/bed/inn,
/obj/machinery/light/fueled/torchholder/c,
/turf/open/floor/herringbone,
/area/rogue/indoors/shelter)
"Bm" = (
/obj/structure/table/wood/plain,
/obj/structure/fluff/millstone,
/turf/open/floor/herringbone,
/area/rogue/indoors/shelter)
"Bz" = (
/obj/structure/window/openclose,
/turf/closed/wall/mineral/stone/window,
/area/rogue/indoors/shelter)
"CX" = (
/obj/machinery/light/fueled/hearth,
/obj/item/cooking/pan,
/turf/open/floor/herringbone,
/area/rogue/indoors/shelter)
"EJ" = (
/obj/effect/dungeon_directional_helper/west,
/turf/open/floor/naturalstone,
/area/rogue/under/cave)
"FA" = (
/obj/structure/closet/crate/crafted_closet/inn,
/obj/item/clothing/shirt/robe/plain,
/turf/open/floor/herringbone,
/area/rogue/indoors/shelter)
"GE" = (
/obj/structure/gate/preopen,
/turf/open/floor/hexstone,
/area/rogue/indoors/shelter)
"Iu" = (
/turf/open/transparent/openspace,
/area/rogue/indoors/shelter)
"IE" = (
/obj/effect/decal/cleanable/sigil/SW,
/turf/open/floor/hexstone,
/area/rogue/indoors/shelter)
"Jb" = (
/obj/structure/fluff/statue/evil,
/turf/open/floor/hexstone,
/area/rogue/indoors/shelter)
"JJ" = (
/turf/open/floor/herringbone,
/area/rogue/indoors/shelter)
"Kf" = (
/obj/structure/fluff/statue/knight/interior/r,
/turf/open/floor/hexstone,
/area/rogue/indoors/shelter)
"Mi" = (
/obj/machinery/light/fueled/torchholder/l,
/turf/open/floor/hexstone,
/area/rogue/indoors/shelter)
"MC" = (
/obj/structure/fluff/statue/knightalt/r,
/turf/open/floor/hexstone,
/area/rogue/indoors/shelter)
"OV" = (
/obj/effect/decal/cleanable/sigil/W,
/turf/open/floor/hexstone,
/area/rogue/indoors/shelter)
"OX" = (
/obj/machinery/light/fueled/firebowl,
/turf/open/floor/dirt,
/area/rogue/under/cave)
"Rt" = (
/obj/effect/dungeon_directional_helper/north,
/turf/open/floor/naturalstone,
/area/rogue/under/cave)
"Ry" = (
/obj/machinery/light/fueled/hearth,
/obj/item/reagent_containers/glass/bucket/pot,
/turf/open/floor/herringbone,
/area/rogue/indoors/shelter)
"Ub" = (
/obj/structure/closet/crate/chest/crafted,
/turf/open/floor/hexstone,
/area/rogue/indoors/shelter)
"Uz" = (
/obj/structure/table/church,
/obj/item/flashlight/flare/torch/metal{
	pixel_y = 7
	},
/obj/item/flashlight/flare/torch/metal{
	pixel_y = 6;
	pixel_x = -8
	},
/obj/item/flashlight/flare/torch/metal{
	pixel_x = 7;
	pixel_y = 6
	},
/turf/open/floor/hexstone,
/area/rogue/indoors/shelter)
"Vt" = (
/obj/machinery/light/fueled/firebowl,
/turf/open/floor/hexstone,
/area/rogue/indoors/shelter)
"Vx" = (
/obj/effect/decal/cleanable/sigil/E,
/turf/open/floor/hexstone,
/area/rogue/indoors/shelter)
"Wo" = (
/obj/machinery/light/fueled/firebowl,
/turf/open/floor/naturalstone,
/area/rogue/under/cave)
"Xm" = (
/obj/effect/decal/cleanable/sigil/SE,
/turf/open/floor/hexstone,
/area/rogue/indoors/shelter)
"Yw" = (
/obj/structure/closet/crate/drawer/inn,
/turf/open/floor/herringbone,
/area/rogue/indoors/shelter)

(1,1,1) = {"
av
av
av
av
av
av
av
av
av
av
av
av
av
av
xl
xl
EJ
xl
xl
xl
av
av
av
av
av
av
av
av
av
av
av
av
av
av
av
"}
(2,1,1) = {"
av
xl
xl
xl
xl
av
av
av
xl
xl
xl
xl
xl
xl
xl
xl
xl
xl
xl
xl
xl
xl
xl
xl
xl
xl
xl
av
av
av
av
av
av
av
av
"}
(3,1,1) = {"
av
xl
xl
xl
av
av
xl
xl
xl
xl
xl
xl
xl
xl
xl
xl
xl
xl
xl
xl
xl
xl
xl
xl
xl
xl
xl
xl
av
av
av
av
av
av
av
"}
(4,1,1) = {"
av
av
xl
av
av
xl
xl
xl
xl
kW
kW
kW
xl
xl
xl
kW
xl
xl
xl
xl
kW
xl
kW
xl
kW
OX
kW
xl
xl
av
av
av
av
av
xl
"}
(5,1,1) = {"
av
av
xl
xl
xl
xl
xl
xl
kW
kW
kW
kW
kW
xl
kW
kW
kW
xl
xl
kW
kW
kW
kW
kW
kW
kW
kW
xl
xl
xl
av
av
av
xl
xl
"}
(6,1,1) = {"
av
av
av
xl
xl
xl
xl
xl
kW
kW
kW
kW
kW
kW
kW
kW
kW
kW
kW
et
et
et
et
et
kW
kW
kW
kW
xl
xl
xl
xl
xl
xl
xl
"}
(7,1,1) = {"
xl
xl
xl
xl
xl
xl
xl
xl
kW
kW
kW
et
et
et
et
et
kW
kW
kW
et
ed
gw
Mi
et
kf
kW
kW
kW
kW
xl
xl
xl
xl
xl
xl
"}
(8,1,1) = {"
xl
xl
xl
xl
xl
xl
xl
xl
kW
kW
kW
et
Vt
gw
gw
et
et
et
et
et
ed
gw
gw
et
sj
kW
kW
kW
kW
xl
xl
xl
xl
xl
xk
"}
(9,1,1) = {"
xl
xl
xl
xl
xl
xl
xl
kW
kW
kW
kW
et
gw
gw
gw
Ac
Vt
Ac
gw
et
et
et
bP
et
kW
kW
kW
kW
kW
xl
xl
xl
xl
xl
xl
"}
(10,1,1) = {"
Rt
xl
xl
xl
xl
xl
xl
kW
kW
kW
kW
et
Ub
gw
gw
gw
gw
gw
gw
gw
gw
gw
gw
et
kW
kW
kW
kW
kW
xl
xl
xl
xl
xl
xl
"}
(11,1,1) = {"
xl
xl
xl
xl
xl
xl
xl
kW
kW
kW
kW
et
tz
gw
Uz
OV
IE
gw
gw
cG
cG
cG
cG
GE
xP
xP
xP
xP
kW
xl
xl
xl
xl
xl
xl
"}
(12,1,1) = {"
xl
xl
xl
xl
xl
xl
xl
kW
kW
kW
kW
et
Jb
gw
uG
yl
ma
gw
gw
cG
cG
cG
cG
gw
xP
xP
uW
xP
kW
xl
xl
xl
xl
xl
xl
"}
(13,1,1) = {"
xl
xl
xl
xl
xl
xl
xl
kW
kW
kW
kW
et
MC
gw
hV
Vx
Xm
gw
gw
cG
cG
cG
cG
gw
xP
xP
xP
xP
kW
xl
xl
xl
xl
xl
av
"}
(14,1,1) = {"
xl
xl
xl
xl
xl
xl
xl
kW
kW
kW
kW
et
gw
gw
gw
gw
gw
gw
gw
gw
gw
gw
gw
et
kW
kW
kW
kW
kW
xl
xl
xl
xl
av
av
"}
(15,1,1) = {"
av
av
av
av
xl
xl
xl
kW
kW
kW
kW
et
gw
gw
gw
Kf
Vt
Kf
gw
gw
gw
gw
gw
et
kW
kW
kW
kW
kW
xl
xl
xl
av
av
av
"}
(16,1,1) = {"
av
av
av
av
xl
xl
xl
kW
kW
kW
kW
et
Vt
gw
gw
et
et
et
et
et
gw
gw
gw
et
kW
kW
kW
kW
kW
xl
xl
xl
av
av
av
"}
(17,1,1) = {"
av
av
av
av
av
xl
xl
xl
kW
kW
kW
et
et
et
et
et
kW
kW
kW
et
gw
gw
Vt
et
kW
kW
kW
kW
xl
xl
xl
xl
av
av
av
"}
(18,1,1) = {"
av
av
av
av
av
av
xl
xl
kW
kW
kW
kW
kW
kW
kW
kW
kW
xl
kW
et
et
et
et
et
kW
kW
kW
kW
xl
xl
av
xl
xl
av
av
"}
(19,1,1) = {"
av
av
av
av
av
av
xl
xl
kW
kW
kW
kW
kW
kW
kW
kW
kW
xl
xl
kW
kW
kW
kW
kW
kW
kW
kW
xl
xl
xl
av
av
xl
av
av
"}
(20,1,1) = {"
av
av
av
av
av
av
xl
xl
xl
kW
xl
xl
kW
kW
kW
kW
xl
xl
kW
kW
kW
xl
kW
kW
kW
kW
xl
xl
xl
xl
xl
av
av
av
av
"}
(21,1,1) = {"
av
av
av
av
av
av
av
xl
xl
xl
xl
xl
xl
xl
xl
xl
xl
xl
xl
xl
xl
xl
xl
Wo
xl
xl
xl
xl
av
av
xl
av
av
av
av
"}
(22,1,1) = {"
av
av
av
av
av
av
av
xl
xl
xl
xl
xl
xl
xl
xl
xl
xl
xl
xl
xl
xl
xl
xl
xl
xl
xl
xl
av
av
av
av
xl
av
av
av
"}
(23,1,1) = {"
av
av
av
av
av
av
av
av
xl
xl
xl
xl
xl
xl
xl
xl
xl
xl
xl
xl
xl
av
xl
xl
xl
xl
xl
xl
av
av
av
xl
xl
av
av
"}
(24,1,1) = {"
av
av
av
av
av
av
av
av
av
av
av
av
av
av
xl
xl
xl
xl
av
xl
av
av
av
av
xl
av
xl
xl
av
av
av
av
av
av
av
"}
(25,1,1) = {"
av
av
av
av
av
av
av
av
av
av
av
av
av
av
av
av
xl
av
av
av
av
av
av
av
av
av
av
av
av
av
av
av
av
av
av
"}

(1,1,2) = {"
av
av
av
av
av
av
av
av
av
av
av
av
av
av
AB
AB
AB
AB
AB
AB
av
av
av
av
av
av
av
av
av
av
av
av
av
av
av
"}
(2,1,2) = {"
av
AB
AB
AB
AB
av
av
av
AB
AB
AB
AB
AB
AB
AB
AB
AB
AB
AB
AB
AB
AB
AB
AB
AB
AB
AB
av
av
av
av
av
av
av
av
"}
(3,1,2) = {"
av
AB
AB
AB
av
av
AB
AB
AB
AB
AB
AB
AB
AB
AB
AB
AB
AB
AB
AB
AB
AB
AB
AB
AB
AB
AB
AB
av
av
av
av
av
av
av
"}
(4,1,2) = {"
av
av
AB
av
av
AB
AB
AB
AB
AB
AB
AB
AB
AB
AB
AB
AB
AB
AB
AB
AB
AB
AB
AB
AB
AB
AB
AB
AB
av
av
av
av
av
AB
"}
(5,1,2) = {"
av
av
AB
AB
AB
AB
AB
AB
AB
AB
AB
AB
AB
AB
AB
AB
AB
AB
AB
AB
AB
AB
AB
AB
AB
AB
AB
AB
AB
AB
av
av
av
AB
AB
"}
(6,1,2) = {"
av
av
av
AB
AB
AB
AB
AB
AB
AB
AB
pd
pd
pd
Bz
pd
pd
pd
pd
pd
pd
pd
pd
pd
AB
AB
AB
AB
AB
AB
AB
AB
AB
AB
AB
"}
(7,1,2) = {"
AB
AB
AB
AB
AB
AB
AB
AB
AB
AB
AB
pd
FA
JJ
JJ
JJ
pd
pI
JJ
os
Iu
wx
ny
pd
AB
AB
AB
AB
AB
AB
AB
AB
AB
AB
AB
"}
(8,1,2) = {"
AB
AB
AB
AB
AB
AB
AB
AB
AB
AB
AB
Bz
Yw
JJ
JJ
JJ
pd
JJ
JJ
os
Iu
JJ
JJ
pd
AB
AB
AB
AB
AB
AB
AB
AB
AB
AB
AB
"}
(9,1,2) = {"
AB
AB
AB
AB
AB
AB
AB
AB
AB
AB
AB
pd
AC
JJ
JJ
JJ
bP
JJ
JJ
JJ
JJ
JJ
JJ
pd
AB
AB
AB
AB
AB
AB
AB
AB
AB
AB
AB
"}
(10,1,2) = {"
AB
AB
AB
AB
AB
AB
AB
AB
AB
AB
AB
pd
pd
pd
pd
pd
pd
bP
pd
pd
pd
pd
pd
pd
AB
AB
AB
AB
AB
AB
AB
AB
AB
AB
AB
"}
(11,1,2) = {"
AB
AB
AB
AB
AB
AB
AB
AB
AB
AB
AB
pd
FA
JJ
JJ
JJ
pd
pI
JJ
JJ
nK
Ry
CX
pd
AB
AB
AB
AB
AB
AB
AB
AB
AB
AB
AB
"}
(12,1,2) = {"
AB
AB
AB
AB
AB
AB
AB
AB
AB
AB
AB
Bz
Yw
JJ
JJ
JJ
bP
JJ
JJ
JJ
JJ
JJ
JJ
Bz
AB
AB
AB
AB
AB
AB
AB
AB
AB
AB
AB
"}
(13,1,2) = {"
AB
AB
AB
AB
AB
AB
AB
AB
AB
AB
AB
pd
AC
JJ
JJ
JJ
pd
pI
JJ
ry
Bm
aF
qs
pd
AB
AB
AB
AB
AB
AB
AB
AB
AB
AB
av
"}
(14,1,2) = {"
AB
AB
AB
AB
AB
AB
AB
AB
AB
AB
AB
pd
pd
pd
pd
pd
pd
bP
pd
pd
pd
pd
pd
pd
AB
AB
AB
AB
AB
AB
AB
AB
AB
av
av
"}
(15,1,2) = {"
av
av
av
av
AB
AB
AB
AB
AB
AB
AB
pd
FA
JJ
JJ
JJ
bP
JJ
JJ
JJ
JJ
JJ
JJ
pd
AB
AB
AB
AB
AB
AB
AB
AB
av
av
av
"}
(16,1,2) = {"
av
av
av
av
AB
AB
AB
AB
AB
AB
AB
Bz
Yw
JJ
JJ
JJ
pd
JJ
JJ
JJ
JJ
md
JJ
pd
AB
AB
AB
AB
AB
AB
AB
AB
av
av
av
"}
(17,1,2) = {"
av
av
av
av
av
AB
AB
AB
AB
AB
AB
pd
AC
JJ
JJ
JJ
pd
pI
JJ
JJ
JJ
JJ
JJ
pd
AB
AB
AB
AB
AB
AB
AB
AB
av
av
av
"}
(18,1,2) = {"
av
av
av
av
av
av
AB
AB
AB
AB
AB
pd
pd
pd
Bz
pd
pd
pd
pd
pd
pd
pd
pd
pd
AB
AB
AB
AB
AB
AB
av
AB
AB
av
av
"}
(19,1,2) = {"
av
av
av
av
av
av
AB
AB
AB
AB
AB
AB
AB
AB
AB
AB
AB
AB
AB
AB
AB
AB
AB
AB
AB
AB
AB
AB
AB
AB
av
av
AB
av
av
"}
(20,1,2) = {"
av
av
av
av
av
av
AB
AB
AB
AB
AB
AB
AB
AB
AB
AB
AB
AB
AB
AB
AB
AB
AB
AB
AB
AB
AB
AB
AB
AB
AB
av
av
av
av
"}
(21,1,2) = {"
av
av
av
av
av
av
av
AB
AB
AB
AB
AB
AB
AB
AB
AB
AB
AB
AB
AB
AB
AB
AB
AB
AB
AB
AB
AB
av
av
AB
av
av
av
av
"}
(22,1,2) = {"
av
av
av
av
av
av
av
AB
AB
AB
AB
AB
AB
AB
AB
AB
AB
AB
AB
AB
AB
AB
AB
AB
AB
AB
AB
av
av
av
av
AB
av
av
av
"}
(23,1,2) = {"
av
av
av
av
av
av
av
av
AB
AB
AB
AB
AB
AB
AB
AB
AB
AB
AB
AB
AB
av
AB
AB
AB
AB
AB
AB
av
av
av
AB
AB
av
av
"}
(24,1,2) = {"
av
av
av
av
av
av
av
av
av
av
av
av
av
av
AB
AB
AB
AB
av
AB
av
av
av
av
AB
av
AB
AB
av
av
av
av
av
av
av
"}
(25,1,2) = {"
av
av
av
av
av
av
av
av
av
av
av
av
av
av
av
av
AB
av
av
av
av
av
av
av
av
av
av
av
av
av
av
av
av
av
av
"}
