//MAP CONVERTED BY dmm2tgm.py THIS HEADER COMMENT PREVENTS RECONVERSION, DO NOT REMOVE
"av" = (
/turf/closed/mineral/rogue/bedrock,
/area/rogue)
"aF" = (
/obj/structure/table/wood/plain,
/turf/open/floor/rogue/herringbone,
/area/rogue)
"bP" = (
/obj/structure/mineral_door/wood,
/turf/open/floor/rogue/herringbone,
/area/rogue)
"cG" = (
/turf/open/floor/carpet/red,
/area/rogue)
"ed" = (
/obj/structure/stairs/stone/church{
	dir = 1
	},
/turf/open/floor/rogue/hexstone,
/area/rogue)
"et" = (
/turf/closed/wall/mineral/rogue/stone,
/area/rogue)
"gw" = (
/turf/open/floor/rogue/hexstone,
/area/rogue)
"hV" = (
/obj/structure/table/church{
	dir = 1
	},
/obj/item/reagent_containers/food/snacks/hardtack{
	pixel_x = 8;
	pixel_y = 12
	},
/obj/item/reagent_containers/food/snacks/hardtack{
	pixel_x = 2;
	pixel_y = 4
	},
/obj/item/reagent_containers/food/snacks/hardtack{
	pixel_x = -7;
	pixel_y = 11
	},
/turf/open/floor/rogue/hexstone,
/area/rogue)
"kf" = (
/obj/structure/closet/crate/chest,
/obj/item/neuFarm/seed/wheat,
/obj/item/neuFarm/seed/wheat,
/obj/item/neuFarm/seed/wheat,
/obj/item/neuFarm/seed/wheat,
/obj/item/neuFarm/seed/wheat,
/obj/item/neuFarm/seed/wheat,
/obj/item/neuFarm/seed/wheat,
/obj/item/rogueweapon/hoe,
/obj/item/rogueweapon/sickle,
/obj/item/rogueweapon/thresher,
/obj/item/neuFarm/seed/onion,
/obj/item/neuFarm/seed/onion,
/obj/item/neuFarm/seed/onion,
/obj/item/neuFarm/seed/onion,
/obj/item/neuFarm/seed/onion,
/obj/item/neuFarm/seed/onion,
/obj/item/neuFarm/seed/cabbage,
/obj/item/neuFarm/seed/cabbage,
/obj/item/neuFarm/seed/cabbage,
/obj/item/neuFarm/seed/cabbage,
/obj/item/neuFarm/seed/apple,
/obj/item/neuFarm/seed/apple,
/obj/item/neuFarm/seed/apple,
/turf/open/floor/rogue/dirt,
/area/rogue)
"kW" = (
/turf/open/floor/rogue/dirt,
/area/rogue)
"ma" = (
/obj/effect/decal/cleanable/sigil/S,
/turf/open/floor/rogue/hexstone,
/area/rogue)
"md" = (
/obj/structure/dungeon_exit,
/turf/open/floor/rogue/herringbone,
/area/rogue)
"ny" = (
/obj/structure/fermentation_keg/random/water,
/turf/open/floor/rogue/herringbone,
/area/rogue)
"nK" = (
/obj/machinery/light/rogue/oven/east,
/turf/open/floor/rogue/herringbone,
/area/rogue)
"os" = (
/obj/structure/stairs/stone/church{
	dir = 1
	},
/turf/open/transparent/openspace,
/area/rogue)
"pd" = (
/turf/closed/wall/mineral/rogue/stone/window,
/area/rogue)
"pI" = (
/obj/machinery/light/rogue/torchholder/c,
/turf/open/floor/rogue/herringbone,
/area/rogue)
"qs" = (
/obj/structure/table/wood/plain,
/obj/item/rogueweapon/knife/cleaver,
/turf/open/floor/rogue/herringbone,
/area/rogue)
"ry" = (
/obj/structure/closet/crate/chest,
/obj/item/reagent_containers/food/snacks/produce/wheat,
/obj/item/reagent_containers/food/snacks/produce/wheat,
/obj/item/reagent_containers/food/snacks/produce/wheat,
/obj/item/reagent_containers/food/snacks/produce/wheat,
/obj/item/reagent_containers/food/snacks/produce/wheat,
/obj/item/reagent_containers/food/snacks/produce/wheat,
/obj/item/reagent_containers/food/snacks/produce/wheat,
/obj/item/reagent_containers/food/snacks/produce/wheat,
/obj/item/reagent_containers/food/snacks/produce/wheat,
/turf/open/floor/rogue/herringbone,
/area/rogue)
"sj" = (
/obj/item/reagent_containers/glass/bucket/wooden/alter,
/turf/open/floor/rogue/dirt,
/area/rogue)
"tz" = (
/obj/structure/fluff/statue/knightalt,
/turf/open/floor/rogue/hexstone,
/area/rogue)
"uG" = (
/obj/structure/table/church/m,
/obj/item/reagent_containers/glass/bottle/waterskin{
	pixel_y = -1;
	pixel_x = -5
	},
/obj/item/reagent_containers/glass/bottle/waterskin{
	pixel_y = 3
	},
/obj/item/reagent_containers/glass/bottle/waterskin{
	pixel_x = 8;
	pixel_y = 7
	},
/turf/open/floor/rogue/hexstone,
/area/rogue)
"uW" = (
/obj/structure/well,
/turf/open/floor/rogue/dirt,
/area/rogue)
"wx" = (
/obj/structure/fermentation_keg/random/beer,
/turf/open/floor/rogue/herringbone,
/area/rogue)
"xk" = (
/obj/effect/dungeon_directional_helper/south,
/turf/open/floor/rogue/naturalstone,
/area/rogue)
"xl" = (
/turf/open/floor/rogue/naturalstone,
/area/rogue)
"yl" = (
/obj/effect/decal/cleanable/sigil,
/obj/effect/decal/cleanable/blood,
/turf/open/floor/rogue/hexstone,
/area/rogue)
"Ac" = (
/obj/structure/fluff/statue/knight/interior,
/turf/open/floor/rogue/hexstone,
/area/rogue)
"AB" = (
/turf/open/transparent/openspace,
/area/rogue)
"AC" = (
/obj/structure/bed/rogue/inn,
/obj/machinery/light/rogue/torchholder/c,
/turf/open/floor/rogue/herringbone,
/area/rogue)
"Bm" = (
/obj/structure/table/wood/plain,
/obj/structure/fluff/millstone,
/turf/open/floor/rogue/herringbone,
/area/rogue)
"Bz" = (
/obj/structure/roguewindow/openclose,
/turf/closed/wall/mineral/rogue/stone/window,
/area/rogue)
"CX" = (
/obj/machinery/light/rogue/hearth,
/obj/item/cooking/pan,
/turf/open/floor/rogue/herringbone,
/area/rogue)
"EJ" = (
/obj/effect/dungeon_directional_helper/west,
/turf/open/floor/rogue/naturalstone,
/area/rogue)
"FA" = (
/obj/structure/closet/crate/roguecloset/inn,
/obj/item/clothing/suit/roguetown/shirt/robe/plain,
/turf/open/floor/rogue/herringbone,
/area/rogue)
"GE" = (
/obj/structure/gate/preopen,
/turf/open/floor/rogue/hexstone,
/area/rogue)
"IE" = (
/obj/effect/decal/cleanable/sigil/SW,
/turf/open/floor/rogue/hexstone,
/area/rogue)
"Jb" = (
/obj/structure/fluff/statue/evil,
/turf/open/floor/rogue/hexstone,
/area/rogue)
"JJ" = (
/turf/open/floor/rogue/herringbone,
/area/rogue)
"Kf" = (
/obj/structure/fluff/statue/knight/interior/r,
/turf/open/floor/rogue/hexstone,
/area/rogue)
"Mi" = (
/obj/machinery/light/rogue/torchholder/l,
/turf/open/floor/rogue/hexstone,
/area/rogue)
"MC" = (
/obj/structure/fluff/statue/knightalt/r,
/turf/open/floor/rogue/hexstone,
/area/rogue)
"OV" = (
/obj/effect/decal/cleanable/sigil/W,
/turf/open/floor/rogue/hexstone,
/area/rogue)
"OX" = (
/obj/machinery/light/rogue/firebowl,
/turf/open/floor/rogue/dirt,
/area/rogue)
"Rt" = (
/obj/effect/dungeon_directional_helper/north,
/turf/open/floor/rogue/naturalstone,
/area/rogue)
"Ry" = (
/obj/machinery/light/rogue/hearth,
/obj/item/reagent_containers/glass/bucket/pot,
/turf/open/floor/rogue/herringbone,
/area/rogue)
"Ub" = (
/obj/structure/closet/crate/chest/crafted,
/turf/open/floor/rogue/hexstone,
/area/rogue)
"Uz" = (
/obj/structure/table/church,
/obj/item/flashlight/flare/torch/metal{
	pixel_y = 7
	},
/obj/item/flashlight/flare/torch/metal{
	pixel_y = 6;
	pixel_x = -8
	},
/obj/item/flashlight/flare/torch/metal{
	pixel_x = 7;
	pixel_y = 6
	},
/turf/open/floor/rogue/hexstone,
/area/rogue)
"Vt" = (
/obj/machinery/light/rogue/firebowl,
/turf/open/floor/rogue/hexstone,
/area/rogue)
"Vx" = (
/obj/effect/decal/cleanable/sigil/E,
/turf/open/floor/rogue/hexstone,
/area/rogue)
"Wo" = (
/obj/machinery/light/rogue/firebowl,
/turf/open/floor/rogue/naturalstone,
/area/rogue)
"Xm" = (
/obj/effect/decal/cleanable/sigil/SE,
/turf/open/floor/rogue/hexstone,
/area/rogue)
"Yw" = (
/obj/structure/closet/crate/drawer/inn,
/turf/open/floor/rogue/herringbone,
/area/rogue)

(1,1,1) = {"
av
av
av
av
av
av
av
av
av
av
av
av
av
av
xl
xl
EJ
xl
xl
xl
av
av
av
av
av
av
av
av
av
av
av
av
av
av
av
"}
(2,1,1) = {"
av
xl
xl
xl
xl
av
av
av
xl
xl
xl
xl
xl
xl
xl
xl
xl
xl
xl
xl
xl
xl
xl
xl
xl
xl
xl
av
av
av
av
av
av
av
av
"}
(3,1,1) = {"
av
xl
xl
xl
av
av
xl
xl
xl
xl
xl
xl
xl
xl
xl
xl
xl
xl
xl
xl
xl
xl
xl
xl
xl
xl
xl
xl
av
av
av
av
av
av
av
"}
(4,1,1) = {"
av
av
xl
av
av
xl
xl
xl
xl
kW
kW
kW
xl
xl
xl
kW
xl
xl
xl
xl
kW
xl
kW
xl
kW
OX
kW
xl
xl
av
av
av
av
av
xl
"}
(5,1,1) = {"
av
av
xl
xl
xl
xl
xl
xl
kW
kW
kW
kW
kW
xl
kW
kW
kW
xl
xl
kW
kW
kW
kW
kW
kW
kW
kW
xl
xl
xl
av
av
av
xl
xl
"}
(6,1,1) = {"
av
av
av
xl
xl
xl
xl
xl
kW
kW
kW
kW
kW
kW
kW
kW
kW
kW
kW
et
et
et
et
et
kW
kW
kW
kW
xl
xl
xl
xl
xl
xl
xl
"}
(7,1,1) = {"
xl
xl
xl
xl
xl
xl
xl
xl
kW
kW
kW
et
et
et
et
et
kW
kW
kW
et
ed
gw
Mi
et
kf
kW
kW
kW
kW
xl
xl
xl
xl
xl
xl
"}
(8,1,1) = {"
xl
xl
xl
xl
xl
xl
xl
xl
kW
kW
kW
et
Vt
gw
gw
et
et
et
et
et
ed
gw
gw
et
sj
kW
kW
kW
kW
xl
xl
xl
xl
xl
xk
"}
(9,1,1) = {"
xl
xl
xl
xl
xl
xl
xl
kW
kW
kW
kW
et
gw
gw
gw
Ac
Vt
Ac
gw
et
et
et
bP
et
kW
kW
kW
kW
kW
xl
xl
xl
xl
xl
xl
"}
(10,1,1) = {"
Rt
xl
xl
xl
xl
xl
xl
kW
kW
kW
kW
et
Ub
gw
gw
gw
gw
gw
gw
gw
gw
gw
gw
et
kW
kW
kW
kW
kW
xl
xl
xl
xl
xl
xl
"}
(11,1,1) = {"
xl
xl
xl
xl
xl
xl
xl
kW
kW
kW
kW
et
tz
gw
Uz
OV
IE
gw
gw
cG
cG
cG
cG
GE
gw
gw
gw
gw
kW
xl
xl
xl
xl
xl
xl
"}
(12,1,1) = {"
xl
xl
xl
xl
xl
xl
xl
kW
kW
kW
kW
et
Jb
gw
uG
yl
ma
gw
gw
cG
cG
cG
cG
gw
gw
gw
uW
gw
kW
xl
xl
xl
xl
xl
xl
"}
(13,1,1) = {"
xl
xl
xl
xl
xl
xl
xl
kW
kW
kW
kW
et
MC
gw
hV
Vx
Xm
gw
gw
cG
cG
cG
cG
gw
gw
gw
gw
gw
kW
xl
xl
xl
xl
xl
av
"}
(14,1,1) = {"
xl
xl
xl
xl
xl
xl
xl
kW
kW
kW
kW
et
gw
gw
gw
gw
gw
gw
gw
gw
gw
gw
gw
et
kW
kW
kW
kW
kW
xl
xl
xl
xl
av
av
"}
(15,1,1) = {"
av
av
av
av
xl
xl
xl
kW
kW
kW
kW
et
gw
gw
gw
Kf
Vt
Kf
gw
gw
gw
gw
gw
et
kW
kW
kW
kW
kW
xl
xl
xl
av
av
av
"}
(16,1,1) = {"
av
av
av
av
xl
xl
xl
kW
kW
kW
kW
et
Vt
gw
gw
et
et
et
et
et
gw
gw
gw
et
kW
kW
kW
kW
kW
xl
xl
xl
av
av
av
"}
(17,1,1) = {"
av
av
av
av
av
xl
xl
xl
kW
kW
kW
et
et
et
et
et
kW
kW
kW
et
gw
gw
Vt
et
kW
kW
kW
kW
xl
xl
xl
xl
av
av
av
"}
(18,1,1) = {"
av
av
av
av
av
av
xl
xl
kW
kW
kW
kW
kW
kW
kW
kW
kW
xl
kW
et
et
et
et
et
kW
kW
kW
kW
xl
xl
av
xl
xl
av
av
"}
(19,1,1) = {"
av
av
av
av
av
av
xl
xl
kW
kW
kW
kW
kW
kW
kW
kW
kW
xl
xl
kW
kW
kW
kW
kW
kW
kW
kW
xl
xl
xl
av
av
xl
av
av
"}
(20,1,1) = {"
av
av
av
av
av
av
xl
xl
xl
kW
xl
xl
kW
kW
kW
kW
xl
xl
kW
kW
kW
xl
kW
kW
kW
kW
xl
xl
xl
xl
xl
av
av
av
av
"}
(21,1,1) = {"
av
av
av
av
av
av
av
xl
xl
xl
xl
xl
xl
xl
xl
xl
xl
xl
xl
xl
xl
xl
xl
Wo
xl
xl
xl
xl
av
av
xl
av
av
av
av
"}
(22,1,1) = {"
av
av
av
av
av
av
av
xl
xl
xl
xl
xl
xl
xl
xl
xl
xl
xl
xl
xl
xl
xl
xl
xl
xl
xl
xl
av
av
av
av
xl
av
av
av
"}
(23,1,1) = {"
av
av
av
av
av
av
av
av
xl
xl
xl
xl
xl
xl
xl
xl
xl
xl
xl
xl
xl
av
xl
xl
xl
xl
xl
xl
av
av
av
xl
xl
av
av
"}
(24,1,1) = {"
av
av
av
av
av
av
av
av
av
av
av
av
av
av
xl
xl
xl
xl
av
xl
av
av
av
av
xl
av
xl
xl
av
av
av
av
av
av
av
"}
(25,1,1) = {"
av
av
av
av
av
av
av
av
av
av
av
av
av
av
av
av
xl
av
av
av
av
av
av
av
av
av
av
av
av
av
av
av
av
av
av
"}

(1,1,2) = {"
AB
AB
AB
AB
AB
AB
AB
AB
AB
AB
AB
AB
AB
AB
AB
AB
AB
AB
AB
AB
AB
AB
AB
AB
AB
AB
AB
AB
AB
AB
AB
AB
AB
AB
AB
"}
(2,1,2) = {"
AB
AB
AB
AB
AB
AB
AB
AB
AB
AB
AB
AB
AB
AB
AB
AB
AB
AB
AB
AB
AB
AB
AB
AB
AB
AB
AB
AB
AB
AB
AB
AB
AB
AB
AB
"}
(3,1,2) = {"
AB
AB
AB
AB
AB
AB
AB
AB
AB
AB
AB
AB
AB
AB
AB
AB
AB
AB
AB
AB
AB
AB
AB
AB
AB
AB
AB
AB
AB
AB
AB
AB
AB
AB
AB
"}
(4,1,2) = {"
AB
AB
AB
AB
AB
AB
AB
AB
AB
AB
AB
AB
AB
AB
AB
AB
AB
AB
AB
AB
AB
AB
AB
AB
AB
AB
AB
AB
AB
AB
AB
AB
AB
AB
AB
"}
(5,1,2) = {"
AB
AB
AB
AB
AB
AB
AB
AB
AB
AB
AB
AB
AB
AB
AB
AB
AB
AB
AB
AB
AB
AB
AB
AB
AB
AB
AB
AB
AB
AB
AB
AB
AB
AB
AB
"}
(6,1,2) = {"
AB
AB
AB
AB
AB
AB
AB
AB
AB
AB
AB
pd
pd
pd
Bz
pd
pd
pd
pd
pd
pd
pd
pd
pd
AB
AB
AB
AB
AB
AB
AB
AB
AB
AB
AB
"}
(7,1,2) = {"
AB
AB
AB
AB
AB
AB
AB
AB
AB
AB
AB
pd
FA
JJ
JJ
JJ
pd
pI
JJ
os
AB
wx
ny
pd
AB
AB
AB
AB
AB
AB
AB
AB
AB
AB
AB
"}
(8,1,2) = {"
AB
AB
AB
AB
AB
AB
AB
AB
AB
AB
AB
Bz
Yw
JJ
JJ
JJ
pd
JJ
JJ
os
AB
JJ
JJ
pd
AB
AB
AB
AB
AB
AB
AB
AB
AB
AB
AB
"}
(9,1,2) = {"
AB
AB
AB
AB
AB
AB
AB
AB
AB
AB
AB
pd
AC
JJ
JJ
JJ
bP
JJ
JJ
JJ
JJ
JJ
JJ
pd
AB
AB
AB
AB
AB
AB
AB
AB
AB
AB
AB
"}
(10,1,2) = {"
AB
AB
AB
AB
AB
AB
AB
AB
AB
AB
AB
pd
pd
pd
pd
pd
pd
bP
pd
pd
pd
pd
pd
pd
AB
AB
AB
AB
AB
AB
AB
AB
AB
AB
AB
"}
(11,1,2) = {"
AB
AB
AB
AB
AB
AB
AB
AB
AB
AB
AB
pd
FA
JJ
JJ
JJ
pd
pI
JJ
JJ
nK
Ry
CX
pd
AB
AB
AB
AB
AB
AB
AB
AB
AB
AB
AB
"}
(12,1,2) = {"
AB
AB
AB
AB
AB
AB
AB
AB
AB
AB
AB
Bz
Yw
JJ
JJ
JJ
bP
JJ
JJ
JJ
JJ
JJ
JJ
Bz
AB
AB
AB
AB
AB
AB
AB
AB
AB
AB
AB
"}
(13,1,2) = {"
AB
AB
AB
AB
AB
AB
AB
AB
AB
AB
AB
pd
AC
JJ
JJ
JJ
pd
pI
JJ
ry
Bm
aF
qs
pd
AB
AB
AB
AB
AB
AB
AB
AB
AB
AB
AB
"}
(14,1,2) = {"
AB
AB
AB
AB
AB
AB
AB
AB
AB
AB
AB
pd
pd
pd
pd
pd
pd
bP
pd
pd
pd
pd
pd
pd
AB
AB
AB
AB
AB
AB
AB
AB
AB
AB
AB
"}
(15,1,2) = {"
AB
AB
AB
AB
AB
AB
AB
AB
AB
AB
AB
pd
FA
JJ
JJ
JJ
bP
JJ
JJ
JJ
JJ
JJ
JJ
pd
AB
AB
AB
AB
AB
AB
AB
AB
AB
AB
AB
"}
(16,1,2) = {"
AB
AB
AB
AB
AB
AB
AB
AB
AB
AB
AB
Bz
Yw
JJ
JJ
JJ
pd
JJ
JJ
JJ
JJ
md
JJ
pd
AB
AB
AB
AB
AB
AB
AB
AB
AB
AB
AB
"}
(17,1,2) = {"
AB
AB
AB
AB
AB
AB
AB
AB
AB
AB
AB
pd
AC
JJ
JJ
JJ
pd
pI
JJ
JJ
JJ
JJ
JJ
pd
AB
AB
AB
AB
AB
AB
AB
AB
AB
AB
AB
"}
(18,1,2) = {"
AB
AB
AB
AB
AB
AB
AB
AB
AB
AB
AB
pd
pd
pd
Bz
pd
pd
pd
pd
pd
pd
pd
pd
pd
AB
AB
AB
AB
AB
AB
AB
AB
AB
AB
AB
"}
(19,1,2) = {"
AB
AB
AB
AB
AB
AB
AB
AB
AB
AB
AB
AB
AB
AB
AB
AB
AB
AB
AB
AB
AB
AB
AB
AB
AB
AB
AB
AB
AB
AB
AB
AB
AB
AB
AB
"}
(20,1,2) = {"
AB
AB
AB
AB
AB
AB
AB
AB
AB
AB
AB
AB
AB
AB
AB
AB
AB
AB
AB
AB
AB
AB
AB
AB
AB
AB
AB
AB
AB
AB
AB
AB
AB
AB
AB
"}
(21,1,2) = {"
AB
AB
AB
AB
AB
AB
AB
AB
AB
AB
AB
AB
AB
AB
AB
AB
AB
AB
AB
AB
AB
AB
AB
AB
AB
AB
AB
AB
AB
AB
AB
AB
AB
AB
AB
"}
(22,1,2) = {"
AB
AB
AB
AB
AB
AB
AB
AB
AB
AB
AB
AB
AB
AB
AB
AB
AB
AB
AB
AB
AB
AB
AB
AB
AB
AB
AB
AB
AB
AB
AB
AB
AB
AB
AB
"}
(23,1,2) = {"
AB
AB
AB
AB
AB
AB
AB
AB
AB
AB
AB
AB
AB
AB
AB
AB
AB
AB
AB
AB
AB
AB
AB
AB
AB
AB
AB
AB
AB
AB
AB
AB
AB
AB
AB
"}
(24,1,2) = {"
AB
AB
AB
AB
AB
AB
AB
AB
AB
AB
AB
AB
AB
AB
AB
AB
AB
AB
AB
AB
AB
AB
AB
AB
AB
AB
AB
AB
AB
AB
AB
AB
AB
AB
AB
"}
(25,1,2) = {"
AB
AB
AB
AB
AB
AB
AB
AB
AB
AB
AB
AB
AB
AB
AB
AB
AB
AB
AB
AB
AB
AB
AB
AB
AB
AB
AB
AB
AB
AB
AB
AB
AB
AB
AB
"}
