//MAP CONVERTED BY dmm2tgm.py THIS HEADER COMMENT PREVENTS RECONVERSION, DO NOT REMOVE
"aF" = (
/obj/structure/fluff/statue/evil,
/turf/open/floor/hexstone,
/area/rogue/indoors/shelter)
"aV" = (
/obj/structure/lever/wall{
	dir = 8;
	redstone_id = northgatematt
	},
/turf/open/floor/hexstone,
/area/rogue/indoors/shelter)
"aW" = (
/turf/closed/wall/mineral/stone/window,
/area/rogue/indoors/shelter)
"cT" = (
/obj/effect/dungeon_directional_helper/south,
/turf/open/floor/hexstone,
/area/rogue/under/cave)
"cX" = (
/obj/structure/fluff/railing/border,
/turf/open/floor/ruinedwood/spiral,
/area/rogue/indoors/shelter)
"du" = (
/obj/structure/fermentation_keg/random/beer,
/turf/open/floor/ruinedwood/spiral,
/area/rogue/indoors/shelter)
"dY" = (
/obj/structure/table/church,
/obj/item/flashlight/flare/torch/metal{
	pixel_y = 7
	},
/obj/item/flashlight/flare/torch/metal{
	pixel_y = 6;
	pixel_x = -8
	},
/obj/item/flashlight/flare/torch/metal{
	pixel_x = 7;
	pixel_y = 6
	},
/turf/open/floor/carpet/red,
/area/rogue/indoors/shelter)
"el" = (
/obj/structure/mineral_door/wood/donjon/stone,
/turf/closed/wall/mineral/stone,
/area/rogue/indoors/shelter)
"er" = (
/obj/structure/fermentation_keg,
/turf/open/floor/hexstone,
/area/rogue/indoors/shelter)
"eJ" = (
/obj/structure/rack/shelf/biggest,
/obj/item/reagent_containers/glass/cup/wooden{
	pixel_y = -7
	},
/obj/item/reagent_containers/glass/cup/wooden{
	pixel_x = -5;
	pixel_y = 12
	},
/obj/item/reagent_containers/glass/cup/wooden{
	pixel_x = 8;
	pixel_y = 10
	},
/turf/open/floor/ruinedwood/spiral,
/area/rogue/indoors/shelter)
"fr" = (
/obj/structure/roguetent,
/turf/open/floor/dirt,
/area/rogue/indoors/shelter)
"fx" = (
/turf/open/floor/ruinedwood/spiral,
/area/rogue/under/cave)
"fL" = (
/turf/closed/wall/mineral/stone/window/moss,
/area/rogue/indoors/shelter)
"fM" = (
/obj/structure/fermentation_keg/random/beer,
/turf/open/floor/hexstone,
/area/rogue/indoors/shelter)
"gi" = (
/obj/structure/fluff/statue/knightalt/r,
/turf/open/floor/hexstone,
/area/rogue/indoors/shelter)
"gz" = (
/obj/structure/closet/crate/drawer/inn,
/turf/open/floor/ruinedwood/spiral,
/area/rogue/indoors/shelter)
"iu" = (
/obj/structure/stairs/stone/church{
	dir = 1
	},
/turf/open/floor/dirt,
/area/rogue/under/cave)
"iH" = (
/obj/structure/bars,
/turf/open/floor/hexstone,
/area/rogue/indoors/shelter)
"jA" = (
/turf/open/floor/hexstone,
/area/rogue/indoors/shelter)
"jN" = (
/obj/structure/wallladder{
	dir = 1
	},
/turf/open/floor/dirt,
/area/rogue/under/cave)
"jS" = (
/obj/structure/stairs/stone/church{
	dir = 4
	},
/turf/open/floor/ruinedwood/spiral,
/area/rogue/indoors/shelter)
"jX" = (
/obj/machinery/light/fueled/firebowl,
/turf/open/floor/hexstone,
/area/rogue/indoors/shelter)
"kn" = (
/obj/machinery/light/fueled/firebowl,
/turf/open/floor/ruinedwood/spiral,
/area/rogue/indoors/shelter)
"kN" = (
/obj/structure/mineral_door/wood/deadbolt{
	dir = 4
	},
/turf/open/floor/ruinedwood/spiral,
/area/rogue/indoors/shelter)
"kT" = (
/turf/closed/mineral/bedrock,
/area/rogue/under/cave)
"lW" = (
/obj/structure/fluff/railing/border{
	dir = 1
	},
/turf/open/floor/ruinedwood/spiral,
/area/rogue/under/cave)
"mA" = (
/obj/structure/wallladder{
	dir = 4
	},
/turf/open/floor/dirt,
/area/rogue/under/cave)
"mV" = (
/obj/structure/table/wood/reinf_long,
/obj/structure/bars/alt,
/turf/open/floor/ruinedwood/spiral,
/area/rogue/indoors/shelter)
"nA" = (
/obj/structure/fluff/railing/border{
	dir = 4
	},
/turf/open/floor/ruinedwood/spiral,
/area/rogue/under/cave)
"oj" = (
/obj/structure/stairs/stone/church{
	dir = 1
	},
/turf/open/floor/ruinedwood/spiral,
/area/rogue/indoors/shelter)
"oB" = (
/obj/structure/table/wood/reinforced_alter,
/obj/structure/bars/alt,
/turf/open/floor/ruinedwood/spiral,
/area/rogue/indoors/shelter)
"pm" = (
/obj/structure/bed/hay,
/turf/open/floor/hexstone,
/area/rogue/indoors/shelter)
"qn" = (
/obj/effect/dungeon_directional_helper/west,
/turf/open/floor/hexstone,
/area/rogue/under/cave)
"qo" = (
/obj/structure/chair/stool,
/turf/open/floor/naturalstone,
/area/rogue/under/cave)
"qX" = (
/obj/structure/mineral_door/wood/donjon/stone,
/turf/open/floor/hexstone,
/area/rogue/indoors/shelter)
"sQ" = (
/obj/machinery/light/fueled/torchholder/r,
/turf/open/floor/hexstone,
/area/rogue/indoors/shelter)
"sX" = (
/obj/effect/dungeon_directional_helper/east,
/turf/open/floor/hexstone,
/area/rogue/under/cave)
"uj" = (
/obj/structure/dungeon_exit,
/turf/open/floor/ruinedwood/spiral,
/area/rogue/indoors/shelter)
"uy" = (
/turf/closed/mineral/bedrock,
/area/rogue/indoors/shelter)
"uO" = (
/obj/structure/closet/crate/crafted_closet/inn/south,
/turf/open/floor/ruinedwood/spiral,
/area/rogue/indoors/shelter)
"wx" = (
/obj/machinery/light/fueled/campfire/longlived,
/turf/open/floor/naturalstone,
/area/rogue/under/cave)
"xm" = (
/obj/structure/table/wood/plain/alt,
/turf/open/floor/ruinedwood/spiral,
/area/rogue/indoors/shelter)
"yg" = (
/turf/closed/wall/mineral/tent,
/area/rogue/indoors/shelter)
"yr" = (
/turf/open/transparent/openspace,
/area/rogue/under/cave)
"zI" = (
/turf/open/transparent/openspace,
/area/rogue/indoors/shelter)
"AR" = (
/turf/closed/wall/mineral/stone,
/area/rogue/indoors/shelter)
"Bz" = (
/turf/open/floor/carpet/red,
/area/rogue/indoors/shelter)
"CE" = (
/turf/closed/wall/mineral/stone/moss,
/area/rogue/indoors/shelter)
"Di" = (
/obj/structure/fluff/statue/knight/interior,
/turf/open/floor/naturalstone,
/area/rogue/under/cave)
"DK" = (
/obj/structure/fluff/railing/border{
	dir = 8
	},
/obj/structure/fluff/railing/border{
	dir = 8
	},
/turf/open/floor/ruinedwood/spiral,
/area/rogue/under/cave)
"DY" = (
/obj/structure/fermentation_keg/random/water,
/turf/open/floor/ruinedwood/spiral,
/area/rogue/indoors/shelter)
"EL" = (
/obj/structure/fluff/railing/border{
	dir = 8
	},
/turf/open/floor/ruinedwood/spiral,
/area/rogue/under/cave)
"Fo" = (
/obj/structure/rack/shelf/biggest,
/turf/open/floor/ruinedwood/spiral,
/area/rogue/indoors/shelter)
"Gx" = (
/turf/open/floor/hexstone,
/area/rogue/under/cave)
"GF" = (
/obj/structure/table/wood/plain/alt,
/turf/open/floor/hexstone,
/area/rogue/indoors/shelter)
"Hc" = (
/obj/structure/wallladder{
	dir = 1
	},
/turf/open/floor/naturalstone,
/area/rogue/under/cave)
"Hq" = (
/obj/item/chair/stool/bar/crafted,
/turf/open/floor/naturalstone,
/area/rogue/under/cave)
"Io" = (
/obj/structure/fluff/railing/border,
/obj/structure/table/wood/plain/alt,
/obj/item/reagent_containers/glass/cup/skull,
/turf/open/floor/ruinedwood/spiral,
/area/rogue/indoors/shelter)
"Iv" = (
/obj/structure/fluff/railing/border,
/obj/structure/chair/stool,
/turf/open/floor/ruinedwood/spiral,
/area/rogue/indoors/shelter)
"Jv" = (
/obj/structure/chair/stool,
/turf/open/floor/dirt,
/area/rogue/under/cave)
"Kk" = (
/turf/open/floor/naturalstone,
/area/rogue/under/cave)
"Lj" = (
/obj/structure/fluff/statue/knight/interior/r,
/turf/open/floor/naturalstone,
/area/rogue/under/cave)
"Lo" = (
/obj/structure/bed/shit,
/turf/open/floor/naturalstone,
/area/rogue/indoors/shelter)
"LJ" = (
/turf/closed/wall/mineral/wooddark,
/area/rogue/under/cave)
"LT" = (
/obj/structure/gate{
	redstone_id = northgatematt
	},
/turf/open/floor/hexstone,
/area/rogue/indoors/shelter)
"Ob" = (
/turf/open/floor/ruinedwood/spiral,
/area/rogue/indoors/shelter)
"OM" = (
/obj/structure/fluff/railing/border{
	dir = 8
	},
/turf/open/floor/ruinedwood/spiral,
/area/rogue/indoors/shelter)
"OS" = (
/obj/machinery/light/fueled/torchholder/r,
/turf/open/floor/ruinedwood/spiral,
/area/rogue/indoors/shelter)
"PL" = (
/obj/structure/table/church/m,
/obj/item/reagent_containers/glass/bottle/waterskin{
	pixel_y = -1;
	pixel_x = -5
	},
/obj/item/reagent_containers/glass/bottle/waterskin{
	pixel_y = 3
	},
/obj/item/reagent_containers/glass/bottle/waterskin{
	pixel_x = 8;
	pixel_y = 7
	},
/turf/open/floor/carpet/red,
/area/rogue/indoors/shelter)
"Qn" = (
/obj/structure/roguetent,
/turf/open/floor/naturalstone,
/area/rogue/indoors/shelter)
"RE" = (
/obj/structure/stairs/stone/church{
	dir = 4
	},
/turf/open/floor/naturalstone,
/area/rogue/under/cave)
"RI" = (
/obj/structure/mineral_door/wood/deadbolt,
/turf/open/floor/ruinedwood/spiral,
/area/rogue/indoors/shelter)
"RR" = (
/obj/structure/fermentation_keg/random/water,
/turf/open/floor/hexstone,
/area/rogue/indoors/shelter)
"SG" = (
/turf/open/floor/dirt,
/area/rogue/under/cave)
"Ti" = (
/obj/structure/fluff/statue/knightalt,
/turf/open/floor/hexstone,
/area/rogue/indoors/shelter)
"Tq" = (
/obj/structure/chair/stool,
/turf/open/floor/ruinedwood/spiral,
/area/rogue/indoors/shelter)
"TK" = (
/obj/structure/bed/inn,
/turf/open/floor/ruinedwood/spiral,
/area/rogue/indoors/shelter)
"Vm" = (
/obj/machinery/light/fueled/torchholder/l,
/turf/open/floor/hexstone,
/area/rogue/indoors/shelter)
"Wd" = (
/obj/structure/table/wood/plain/alt,
/obj/machinery/light/fueled/torchholder/r,
/turf/open/floor/hexstone,
/area/rogue/indoors/shelter)
"Wl" = (
/obj/structure/table/wood/reinf_long{
	dir = 1
	},
/obj/structure/bars/alt,
/turf/open/floor/ruinedwood/spiral,
/area/rogue/indoors/shelter)
"Yp" = (
/obj/item/chair/stool/bar/crafted,
/turf/open/floor/ruinedwood/spiral,
/area/rogue/indoors/shelter)
"Yx" = (
/obj/structure/table/church{
	dir = 1
	},
/obj/item/reagent_containers/food/snacks/hardtack{
	pixel_x = 8;
	pixel_y = 12
	},
/obj/item/reagent_containers/food/snacks/hardtack{
	pixel_x = 2;
	pixel_y = 4
	},
/obj/item/reagent_containers/food/snacks/hardtack{
	pixel_x = -7;
	pixel_y = 11
	},
/turf/open/floor/carpet/red,
/area/rogue/indoors/shelter)

(1,1,1) = {"
kT
kT
kT
kT
kT
kT
kT
kT
kT
kT
kT
kT
kT
Kk
Kk
Kk
LJ
Gx
qn
LJ
SG
kT
kT
kT
kT
"}
(2,1,1) = {"
kT
kT
kT
kT
kT
kT
kT
kT
kT
kT
kT
kT
kT
SG
SG
Kk
LJ
Gx
Gx
LJ
jN
kT
kT
kT
kT
"}
(3,1,1) = {"
kT
kT
kT
kT
kT
kT
kT
kT
kT
kT
kT
kT
kT
SG
SG
Kk
SG
Gx
Gx
SG
SG
kT
kT
kT
kT
"}
(4,1,1) = {"
kT
kT
kT
kT
kT
kT
kT
kT
kT
kT
kT
kT
Kk
Kk
Kk
Kk
SG
Gx
Gx
SG
SG
kT
kT
kT
kT
"}
(5,1,1) = {"
kT
kT
kT
kT
kT
kT
kT
kT
kT
kT
kT
Kk
yg
yg
yg
SG
SG
Gx
Gx
SG
SG
SG
SG
SG
kT
"}
(6,1,1) = {"
kT
kT
kT
kT
kT
kT
kT
kT
kT
kT
Kk
Kk
yg
Lo
fr
Kk
SG
Gx
Gx
SG
SG
kT
Kk
kT
kT
"}
(7,1,1) = {"
kT
kT
kT
kT
kT
kT
kT
kT
kT
kT
kT
Kk
yg
yg
yg
Kk
SG
Gx
Gx
SG
Kk
kT
Kk
kT
kT
"}
(8,1,1) = {"
kT
kT
kT
kT
kT
kT
kT
kT
kT
kT
kT
Kk
Kk
Kk
SG
Kk
SG
Gx
Gx
SG
SG
kT
kT
kT
kT
"}
(9,1,1) = {"
kT
kT
kT
kT
kT
kT
kT
kT
kT
kT
Kk
SG
yg
yg
yg
SG
SG
Gx
Gx
SG
Kk
Kk
Kk
kT
kT
"}
(10,1,1) = {"
kT
kT
kT
kT
kT
kT
kT
kT
kT
kT
Kk
Kk
yg
Lo
Qn
Kk
SG
Gx
Gx
SG
SG
kT
SG
kT
kT
"}
(11,1,1) = {"
kT
kT
kT
kT
kT
kT
kT
kT
Kk
Hq
Kk
Kk
yg
yg
yg
Kk
SG
Gx
Gx
SG
SG
kT
Kk
Kk
kT
"}
(12,1,1) = {"
kT
kT
kT
kT
kT
kT
kT
Kk
Kk
Kk
Kk
SG
SG
SG
Kk
SG
SG
Gx
Gx
SG
SG
kT
kT
Kk
kT
"}
(13,1,1) = {"
kT
kT
kT
kT
kT
kT
Kk
Kk
RE
RE
Kk
Kk
Kk
Kk
Kk
Kk
SG
Gx
Gx
SG
SG
Kk
kT
kT
kT
"}
(14,1,1) = {"
kT
kT
kT
kT
AR
CE
CE
CE
AR
AR
CE
CE
CE
SG
SG
Kk
SG
Gx
Gx
SG
SG
Kk
kT
kT
kT
"}
(15,1,1) = {"
kT
kT
kT
kT
AR
Vm
jA
jA
jA
Vm
jA
jA
AR
Kk
SG
SG
SG
Gx
Gx
SG
SG
Kk
Kk
kT
kT
"}
(16,1,1) = {"
kT
kT
kT
kT
CE
jA
jA
jA
jA
jA
jA
jA
CE
Kk
SG
SG
SG
Gx
Gx
SG
SG
SG
SG
Kk
kT
"}
(17,1,1) = {"
kT
kT
kT
kT
CE
Wd
pm
GF
pm
Wd
pm
jA
CE
Kk
SG
SG
SG
Gx
Gx
SG
SG
Kk
Kk
Kk
Kk
"}
(18,1,1) = {"
kT
kT
kT
kT
AR
AR
CE
CE
AR
CE
AR
el
CE
CE
CE
CE
SG
Gx
Gx
SG
Kk
Kk
SG
Kk
Kk
"}
(19,1,1) = {"
kT
kT
kT
kT
CE
jX
jA
jA
jA
jA
jA
jA
CE
aV
jA
AR
iu
Gx
Gx
SG
Kk
Kk
SG
Kk
Kk
"}
(20,1,1) = {"
kT
kT
kT
kT
AR
jA
jA
jA
jA
jA
jA
jA
qX
jA
jA
CE
iu
Gx
Gx
SG
SG
SG
SG
mA
SG
"}
(21,1,1) = {"
kT
kT
kT
kT
CE
jA
jA
jA
jA
jA
jA
jA
CE
iH
iH
CE
Di
Gx
Gx
SG
SG
SG
SG
LJ
LJ
"}
(22,1,1) = {"
kT
kT
kT
kT
CE
Ti
Bz
dY
Bz
Bz
Bz
jA
LT
jA
jA
Vm
Gx
Gx
Gx
Gx
Gx
Gx
Gx
Gx
Gx
"}
(23,1,1) = {"
kT
kT
kT
kT
CE
aF
Bz
PL
Bz
Bz
Bz
jA
jA
jA
jA
jA
Gx
Gx
Gx
Gx
Gx
Gx
Gx
Gx
cT
"}
(24,1,1) = {"
kT
kT
kT
kT
CE
gi
Bz
Yx
Bz
Bz
Bz
jA
jA
jA
jA
sQ
Gx
Gx
Gx
Gx
Gx
Gx
Gx
Gx
Gx
"}
(25,1,1) = {"
kT
kT
kT
kT
AR
jA
jA
jA
jA
jA
jA
jA
CE
iH
iH
CE
Lj
Gx
Gx
SG
SG
SG
SG
LJ
LJ
"}
(26,1,1) = {"
kT
kT
kT
kT
AR
jA
jA
jA
jA
jA
jA
jA
qX
jA
jA
AR
SG
Gx
Gx
SG
Kk
Kk
Kk
Kk
Kk
"}
(27,1,1) = {"
kT
kT
kT
kT
CE
jX
jA
jA
jA
jA
jA
jA
AR
jA
jA
CE
SG
Gx
Gx
SG
Kk
SG
SG
SG
Kk
"}
(28,1,1) = {"
kT
kT
kT
kT
CE
AR
CE
CE
CE
CE
AR
el
CE
CE
CE
CE
SG
Gx
Gx
SG
Kk
Kk
SG
Kk
Kk
"}
(29,1,1) = {"
kT
kT
kT
kT
AR
RR
RR
RR
RR
jA
jA
jA
CE
Kk
Kk
Kk
SG
Gx
Gx
SG
SG
SG
Kk
kT
kT
"}
(30,1,1) = {"
kT
kT
kT
kT
AR
jA
jA
jA
jA
jA
jA
jA
CE
yg
yg
yg
SG
Gx
Gx
SG
SG
SG
kT
Kk
kT
"}
(31,1,1) = {"
kT
kT
kT
kT
AR
fM
er
er
fM
jA
jA
jA
AR
yg
Lo
yg
SG
Gx
Gx
SG
Kk
Kk
Kk
SG
kT
"}
(32,1,1) = {"
kT
kT
kT
kT
AR
CE
CE
AR
CE
CE
AR
CE
CE
yg
Qn
yg
SG
Gx
Gx
SG
Kk
kT
kT
Kk
kT
"}
(33,1,1) = {"
kT
kT
kT
kT
kT
kT
kT
Kk
yg
yg
yg
SG
Kk
qo
Kk
Kk
SG
Gx
Gx
SG
Kk
Kk
Kk
SG
kT
"}
(34,1,1) = {"
kT
kT
kT
kT
kT
kT
kT
Kk
yg
Lo
Qn
SG
Jv
wx
Kk
SG
SG
Gx
Gx
SG
SG
Kk
SG
kT
kT
"}
(35,1,1) = {"
kT
kT
kT
kT
kT
kT
kT
kT
yg
yg
yg
Kk
Kk
Kk
qo
Kk
SG
Gx
Gx
SG
Kk
Kk
Kk
Kk
kT
"}
(36,1,1) = {"
kT
kT
kT
kT
kT
kT
kT
kT
kT
Kk
Kk
SG
yg
Qn
yg
Kk
SG
Gx
Gx
SG
Kk
kT
kT
kT
kT
"}
(37,1,1) = {"
kT
kT
kT
kT
kT
kT
kT
kT
kT
kT
Kk
Kk
yg
Lo
yg
Kk
SG
Gx
Gx
SG
Kk
kT
kT
kT
kT
"}
(38,1,1) = {"
kT
kT
kT
kT
kT
kT
kT
kT
kT
kT
Kk
Kk
yg
yg
yg
Kk
SG
Gx
Gx
SG
Kk
kT
kT
kT
kT
"}
(39,1,1) = {"
kT
kT
kT
kT
kT
kT
kT
kT
kT
kT
kT
Kk
Kk
Kk
Kk
SG
SG
Gx
Gx
SG
Kk
kT
kT
kT
kT
"}
(40,1,1) = {"
kT
kT
kT
kT
kT
kT
kT
kT
kT
kT
kT
Kk
SG
SG
Kk
Kk
SG
Gx
Gx
SG
Kk
kT
kT
kT
kT
"}
(41,1,1) = {"
kT
kT
kT
kT
kT
kT
kT
kT
kT
kT
kT
kT
Kk
SG
SG
SG
SG
Gx
Gx
SG
Kk
kT
kT
kT
kT
"}
(42,1,1) = {"
kT
kT
kT
kT
kT
kT
kT
kT
kT
kT
kT
kT
Kk
Kk
SG
Kk
SG
Gx
Gx
SG
Kk
kT
kT
kT
kT
"}
(43,1,1) = {"
kT
kT
kT
kT
kT
kT
kT
kT
kT
kT
kT
kT
kT
Kk
Kk
Kk
SG
Gx
Gx
SG
Kk
kT
kT
kT
kT
"}
(44,1,1) = {"
kT
kT
kT
kT
kT
kT
kT
kT
kT
kT
kT
kT
kT
SG
SG
Kk
LJ
Gx
Gx
LJ
Hc
kT
kT
kT
kT
"}
(45,1,1) = {"
kT
kT
kT
kT
kT
kT
kT
kT
kT
kT
kT
kT
kT
SG
SG
SG
LJ
Gx
sX
LJ
Kk
kT
kT
kT
kT
"}

(1,1,2) = {"
kT
kT
kT
kT
kT
kT
kT
kT
kT
kT
kT
kT
kT
yr
yr
yr
fx
fx
fx
fx
yr
kT
kT
kT
kT
"}
(2,1,2) = {"
kT
kT
kT
kT
kT
kT
kT
kT
kT
kT
kT
kT
kT
yr
yr
yr
nA
nA
nA
nA
yr
kT
kT
kT
kT
"}
(3,1,2) = {"
kT
kT
kT
kT
kT
kT
kT
kT
kT
kT
kT
kT
kT
yr
yr
yr
yr
yr
yr
yr
yr
kT
kT
kT
kT
"}
(4,1,2) = {"
kT
kT
kT
kT
kT
kT
kT
kT
kT
kT
kT
kT
yr
yr
yr
yr
yr
yr
yr
yr
yr
kT
kT
kT
kT
"}
(5,1,2) = {"
kT
kT
kT
kT
kT
kT
kT
kT
kT
kT
kT
yr
yg
yg
yg
yr
yr
yr
yr
yr
yr
yr
yr
yr
kT
"}
(6,1,2) = {"
kT
kT
kT
kT
kT
kT
kT
kT
kT
kT
yr
yr
yg
yg
yg
yr
yr
yr
yr
yr
yr
kT
yr
kT
kT
"}
(7,1,2) = {"
kT
kT
kT
kT
kT
kT
kT
kT
kT
kT
kT
yr
yg
yg
yg
yr
yr
yr
yr
yr
yr
kT
yr
kT
kT
"}
(8,1,2) = {"
kT
kT
kT
kT
kT
kT
kT
kT
kT
kT
kT
yr
yr
yr
yr
yr
yr
yr
yr
yr
yr
kT
kT
kT
kT
"}
(9,1,2) = {"
kT
kT
kT
kT
kT
kT
kT
kT
kT
kT
yr
yr
yg
yg
yg
yr
yr
yr
yr
yr
yr
yr
yr
kT
kT
"}
(10,1,2) = {"
kT
kT
kT
kT
kT
kT
kT
kT
kT
kT
yr
yr
yg
yg
yg
yr
yr
yr
yr
yr
yr
kT
kT
kT
kT
"}
(11,1,2) = {"
kT
kT
kT
kT
kT
kT
kT
kT
kT
kT
yr
yr
yg
yg
yg
yr
yr
yr
yr
yr
yr
kT
kT
kT
kT
"}
(12,1,2) = {"
kT
kT
kT
kT
kT
kT
kT
yr
yr
yr
yr
yr
yr
yr
yr
yr
yr
yr
yr
yr
yr
kT
kT
kT
kT
"}
(13,1,2) = {"
kT
kT
kT
kT
kT
kT
yr
yr
yr
yr
yr
yr
yr
yr
yr
yr
yr
yr
yr
yr
yr
yr
kT
kT
kT
"}
(14,1,2) = {"
AR
AR
AR
AR
AR
uy
aW
AR
jS
jS
AR
AR
AR
OM
OM
AR
yr
yr
yr
yr
yr
yr
kT
kT
kT
"}
(15,1,2) = {"
AR
Ob
kn
Ob
Tq
Ob
Ob
Ob
Ob
Ob
Tq
Ob
Ob
Ob
Ob
Iv
yr
yr
yr
yr
yr
yr
kT
kT
kT
"}
(16,1,2) = {"
AR
Ob
Ob
Ob
xm
Ob
Ob
Ob
Ob
Ob
xm
Ob
Ob
Ob
Ob
Io
yr
yr
yr
yr
yr
yr
yr
yr
kT
"}
(17,1,2) = {"
AR
Ob
Ob
Ob
Yp
Ob
Tq
Ob
Ob
Ob
Ob
Ob
kn
Ob
Ob
Iv
yr
yr
yr
yr
yr
yr
yr
yr
yr
"}
(18,1,2) = {"
AR
Ob
Ob
Ob
Ob
Ob
xm
Ob
Ob
Ob
Ob
Ob
AR
AR
AR
AR
yr
yr
yr
yr
yr
yr
yr
yr
yr
"}
(19,1,2) = {"
AR
Ob
Ob
Ob
Tq
Ob
Tq
Ob
Ob
xm
Ob
Ob
Ob
Ob
Ob
oj
yr
yr
yr
yr
yr
yr
yr
yr
yr
"}
(20,1,2) = {"
AR
Ob
Ob
Ob
xm
Ob
Ob
Tq
Ob
Tq
Ob
Ob
Ob
Ob
Ob
oj
yr
yr
yr
yr
yr
yr
yr
yr
yr
"}
(21,1,2) = {"
AR
Ob
Ob
Ob
Ob
Ob
Ob
xm
Ob
Ob
Yp
Ob
AR
aW
AR
AR
yr
yr
yr
yr
yr
yr
yr
lW
fx
"}
(22,1,2) = {"
AR
Ob
Ob
Ob
Ob
Ob
Ob
Ob
Ob
Ob
Ob
Ob
cX
yr
yr
yr
yr
yr
yr
yr
yr
yr
yr
lW
fx
"}
(23,1,2) = {"
AR
uj
Ob
Ob
Ob
Ob
Ob
Ob
kn
Ob
Ob
Ob
cX
yr
yr
yr
yr
yr
yr
yr
yr
yr
yr
lW
fx
"}
(24,1,2) = {"
AR
Ob
Ob
Ob
Ob
Ob
Ob
Ob
Ob
Ob
Ob
Ob
cX
yr
yr
yr
yr
yr
yr
yr
yr
yr
yr
lW
fx
"}
(25,1,2) = {"
AR
Ob
Ob
Wl
oB
oB
oB
oB
oB
oB
oB
mV
AR
aW
AR
AR
yr
yr
yr
yr
yr
yr
yr
lW
fx
"}
(26,1,2) = {"
AR
Ob
Ob
AR
Ob
Ob
Ob
Ob
Ob
Ob
Ob
Ob
Ob
Ob
Fo
AR
yr
yr
yr
yr
yr
yr
yr
yr
yr
"}
(27,1,2) = {"
AR
Ob
Ob
RI
OS
Fo
Fo
Ob
OS
Fo
Fo
Fo
Fo
OS
Fo
AR
yr
yr
yr
yr
yr
yr
yr
yr
yr
"}
(28,1,2) = {"
AR
Ob
Ob
AR
AR
AR
AR
kN
AR
AR
AR
AR
AR
AR
AR
AR
yr
yr
yr
yr
yr
yr
yr
yr
yr
"}
(29,1,2) = {"
AR
Ob
Ob
AR
TK
Ob
Ob
Ob
AR
eJ
Fo
Fo
fL
yr
yr
yr
yr
yr
yr
yr
yr
yr
yr
kT
kT
"}
(30,1,2) = {"
AR
Ob
Ob
AR
gz
Ob
Ob
Ob
RI
Ob
Ob
Ob
fL
yg
yg
yg
yr
yr
yr
yr
yr
yr
kT
yr
kT
"}
(31,1,2) = {"
AR
Ob
Ob
AR
uO
Ob
Ob
Ob
aW
du
DY
DY
fL
yg
yg
yg
yr
yr
yr
yr
yr
yr
kT
yr
kT
"}
(32,1,2) = {"
AR
AR
AR
AR
AR
AR
AR
AR
aW
AR
AR
AR
AR
yg
zI
yg
yr
yr
yr
yr
yr
kT
kT
yr
kT
"}
(33,1,2) = {"
kT
kT
kT
kT
kT
kT
kT
yr
yg
yg
yg
yr
yr
yr
yr
yr
yr
yr
yr
yr
yr
yr
yr
yr
kT
"}
(34,1,2) = {"
kT
kT
kT
kT
kT
kT
kT
yr
yg
yg
zI
yr
yr
yr
yr
yr
yr
yr
yr
yr
yr
yr
yr
kT
kT
"}
(35,1,2) = {"
kT
kT
kT
kT
kT
kT
kT
kT
yg
yg
yg
yr
yr
yr
yr
yr
yr
yr
yr
yr
yr
yr
yr
yr
kT
"}
(36,1,2) = {"
kT
kT
kT
kT
kT
kT
kT
kT
kT
yr
yr
yr
yg
zI
yg
yr
yr
yr
yr
yr
yr
kT
kT
kT
kT
"}
(37,1,2) = {"
kT
kT
kT
kT
kT
kT
kT
kT
kT
kT
yr
yr
yg
yg
yg
yr
yr
yr
yr
yr
yr
kT
kT
kT
kT
"}
(38,1,2) = {"
kT
kT
kT
kT
kT
kT
kT
kT
kT
kT
yr
yr
yg
yg
yg
yr
yr
yr
yr
yr
yr
kT
kT
kT
kT
"}
(39,1,2) = {"
kT
kT
kT
kT
kT
kT
kT
kT
kT
kT
kT
yr
yr
yr
yr
yr
yr
yr
yr
yr
yr
kT
kT
kT
kT
"}
(40,1,2) = {"
kT
kT
kT
kT
kT
kT
kT
kT
kT
kT
kT
yr
yr
yr
yr
yr
yr
yr
yr
yr
yr
kT
kT
kT
kT
"}
(41,1,2) = {"
kT
kT
kT
kT
kT
kT
kT
kT
kT
kT
kT
kT
yr
yr
yr
yr
yr
yr
yr
yr
yr
kT
kT
kT
kT
"}
(42,1,2) = {"
kT
kT
kT
kT
kT
kT
kT
kT
kT
kT
kT
kT
yr
yr
yr
yr
yr
yr
yr
yr
yr
kT
kT
kT
kT
"}
(43,1,2) = {"
kT
kT
kT
kT
kT
kT
kT
kT
kT
kT
kT
kT
kT
yr
yr
yr
yr
yr
yr
yr
yr
kT
kT
kT
kT
"}
(44,1,2) = {"
kT
kT
kT
kT
kT
kT
kT
kT
kT
kT
kT
kT
kT
yr
yr
yr
EL
EL
DK
EL
yr
kT
kT
kT
kT
"}
(45,1,2) = {"
kT
kT
kT
kT
kT
kT
kT
kT
kT
kT
kT
kT
kT
yr
yr
yr
fx
fx
fx
fx
yr
kT
kT
kT
kT
"}
