//MAP CONVERTED BY dmm2tgm.py THIS HEADER COMMENT PREVENTS RECONVERSION, DO NOT REMOVE
"a" = (
/turf/closed,
/area/rogue)
"d" = (
/turf/closed/mineral/bedrock,
/area/rogue)
"g" = (
/obj/effect/landmark/start/lich,
/turf/open/floor/blocks/paving,
/area/rogue)
"n" = (
/turf/closed/wall/mineral/wood,
/area/rogue)
"r" = (
/turf/closed/splashscreen,
/area/rogue)
"u" = (
/obj/effect/landmark/start/new_player,
/turf/open/floor/blocks,
/area/rogue)
"x" = (
/obj/effect/landmark/start/vampireknight,
/turf/open/floor/blocks/paving,
/area/rogue)
"y" = (
/obj/effect/landmark/start/vampirespawn,
/turf/open/floor/blocks/paving,
/area/rogue)
"F" = (
/obj/effect/landmark/start/bandit,
/turf/open/floor/blocks/paving,
/area/rogue)
"H" = (
/obj/effect/landmark/admin,
/turf/open/floor/blocks/paving,
/area/rogue)
"P" = (
/obj/effect/landmark/start/vampirelord,
/turf/open/floor/blocks/paving,
/area/rogue)
"X" = (
/turf/closed/basic,
/area/rogue)
"Z" = (
/turf/open/floor/blocks/paving,
/area/rogue)

(1,1,1) = {"
a
a
a
a
a
a
a
a
a
a
a
a
a
a
a
a
a
a
a
a
a
a
a
a
a
a
a
a
a
a
a
a
a
a
X
"}
(2,1,1) = {"
a
a
a
a
a
a
a
a
a
a
a
a
a
a
a
a
a
a
a
a
a
a
a
a
a
a
a
a
a
a
a
a
a
a
X
"}
(3,1,1) = {"
a
a
a
a
a
a
a
a
a
a
a
a
a
a
a
a
a
a
a
a
a
a
a
a
a
a
a
a
a
a
a
a
a
a
X
"}
(4,1,1) = {"
a
a
a
a
a
a
a
a
a
a
a
a
a
a
a
a
a
a
a
a
a
a
a
a
a
a
a
a
a
a
a
a
a
a
X
"}
(5,1,1) = {"
a
a
a
a
a
a
a
a
a
a
a
a
a
a
a
a
a
a
a
a
a
a
a
a
a
a
a
a
a
a
a
a
a
a
X
"}
(6,1,1) = {"
a
a
a
a
a
a
a
a
a
a
a
d
d
d
d
d
d
d
d
d
d
d
d
d
d
d
d
d
a
a
a
a
a
a
X
"}
(7,1,1) = {"
a
a
Z
Z
Z
Z
Z
Z
Z
Z
a
d
n
n
n
n
n
n
n
n
n
n
n
n
n
n
r
d
a
a
a
a
a
a
X
"}
(8,1,1) = {"
a
a
Z
Z
Z
Z
Z
Z
Z
Z
a
d
n
n
n
n
n
n
n
n
n
n
n
n
n
n
n
d
a
a
a
a
a
a
X
"}
(9,1,1) = {"
a
a
Z
Z
Z
Z
Z
Z
Z
Z
a
d
n
n
n
n
n
n
n
n
n
n
n
n
n
n
n
d
a
a
a
a
a
a
X
"}
(10,1,1) = {"
a
a
Z
Z
Z
Z
Z
Z
Z
Z
a
d
n
n
n
n
n
n
n
n
n
n
n
n
n
n
n
d
a
a
a
a
a
a
X
"}
(11,1,1) = {"
a
a
Z
Z
Z
Z
Z
Z
Z
Z
a
d
n
n
n
n
n
n
n
n
n
n
n
n
n
n
n
d
a
a
a
a
a
a
X
"}
(12,1,1) = {"
a
a
Z
P
x
y
Z
Z
Z
Z
a
d
n
n
n
n
n
n
n
n
n
n
n
n
n
n
n
d
a
a
a
a
a
a
X
"}
(13,1,1) = {"
a
a
Z
Z
Z
Z
Z
Z
Z
Z
a
d
n
n
n
n
n
n
n
n
n
n
n
n
n
n
n
d
a
a
a
a
a
a
X
"}
(14,1,1) = {"
a
a
Z
g
Z
Z
Z
Z
Z
Z
a
d
n
n
n
n
n
n
n
u
n
n
n
n
n
n
n
d
a
a
a
a
a
a
X
"}
(15,1,1) = {"
a
a
Z
Z
Z
Z
Z
Z
Z
Z
a
d
n
n
n
n
n
n
n
n
n
n
n
n
n
n
n
d
a
a
a
a
a
a
X
"}
(16,1,1) = {"
a
a
Z
F
Z
Z
Z
Z
Z
Z
a
d
n
n
n
n
n
n
n
n
n
n
n
n
n
n
n
d
a
a
a
a
a
a
X
"}
(17,1,1) = {"
a
a
Z
Z
Z
Z
Z
Z
Z
Z
a
d
n
n
n
n
n
n
n
n
n
n
n
n
n
n
n
d
a
a
a
a
a
a
X
"}
(18,1,1) = {"
a
a
Z
H
Z
Z
Z
Z
Z
Z
a
d
n
n
n
n
n
n
n
n
n
n
n
n
n
n
n
d
a
a
a
a
a
a
X
"}
(19,1,1) = {"
a
a
Z
Z
Z
Z
Z
Z
Z
Z
a
d
n
n
n
n
n
n
n
n
n
n
n
n
n
n
n
d
a
a
a
a
a
a
X
"}
(20,1,1) = {"
a
a
Z
Z
Z
Z
Z
Z
Z
Z
a
d
n
n
n
n
n
n
n
n
n
n
n
n
n
n
n
d
a
a
a
a
a
a
X
"}
(21,1,1) = {"
a
a
Z
Z
Z
Z
Z
Z
Z
Z
a
d
n
n
n
n
n
n
n
n
n
n
n
n
n
n
n
d
a
a
a
a
a
a
X
"}
(22,1,1) = {"
a
a
a
a
a
a
a
a
a
a
a
d
d
d
d
d
d
d
d
d
d
d
d
d
d
d
d
d
a
a
a
a
a
a
X
"}
(23,1,1) = {"
a
a
a
a
a
a
a
a
a
a
a
a
a
a
a
a
a
a
a
a
a
a
a
a
a
a
a
a
a
a
a
a
a
a
X
"}
(24,1,1) = {"
a
a
a
a
a
a
a
a
a
a
a
a
a
a
a
a
a
a
a
a
a
a
a
a
a
a
a
a
a
a
a
a
a
a
X
"}
(25,1,1) = {"
a
a
a
a
a
a
a
a
a
a
a
a
a
a
a
a
a
a
a
a
a
a
a
a
a
a
a
a
a
a
a
a
a
a
X
"}
