//MAP CONVERTED BY dmm2tgm.py THIS HEADER COMMENT PREVENTS RECONVERSION, DO NOT REMOVE
"a" = (
/turf/closed/mineral/bedrock,
/area/rogue/under/cave)
"c" = (
/obj/structure/fluff/railing/fence,
/turf/open/floor/dirt,
/area/rogue/under/cave)
"d" = (
/obj/structure/closet/crate/chest/crafted,
/obj/item/gun/ballistic/revolver/grenadelauncher/bow/long,
/obj/item/ammo_holder/quiver/arrows,
/obj/item/flashlight/flare/torch/lantern,
/obj/effect/decal/cleanable/dirt/cobweb{
	dir = 8
	},
/turf/open/floor/ruinedwood/spiral,
/area/rogue/under/cave)
"e" = (
/turf/open/transparent/openspace,
/area/rogue/under/cave)
"f" = (
/obj/structure/fluff/railing/fence{
	dir = 4
	},
/turf/open/floor/dirt,
/area/rogue/under/cave)
"g" = (
/obj/structure/ladder,
/turf/open/floor/ruinedwood/spiral,
/area/rogue/under/cave)
"h" = (
/obj/structure/table/wood/counter,
/turf/open/floor/ruinedwood/spiral,
/area/rogue/under/cave)
"j" = (
/turf/open/floor/dirt/road,
/area/rogue/under/cave)
"k" = (
/obj/structure/rack,
/obj/item/weapon/shield/wood{
	pixel_x = -5
	},
/obj/item/weapon/shield/wood{
	pixel_x = 8
	},
/obj/item/weapon/shield/tower,
/turf/open/floor/ruinedwood/spiral,
/area/rogue/under/cave)
"l" = (
/turf/open/floor/ruinedwood/spiral,
/area/rogue/under/cave)
"n" = (
/obj/structure/table/wood/counter/end{
	dir = 4
	},
/obj/item/clothing/ring/silver,
/turf/open/floor/ruinedwood/spiral,
/area/rogue/under/cave)
"p" = (
/turf/open/floor/naturalstone,
/area/rogue/under/cave)
"q" = (
/obj/structure/closet/crate/crafted_closet/inn/south,
/turf/open/floor/ruinedwood/spiral,
/area/rogue/under/cave)
"r" = (
/obj/structure/closet/crate/drawer/inn,
/obj/item/ingot/silver,
/turf/open/floor/ruinedwood/spiral,
/area/rogue/under/cave)
"s" = (
/mob/living/carbon/human/species/skeleton/npc/warrior,
/turf/open/floor/dirt/road,
/area/rogue/under/cave)
"t" = (
/obj/effect/dungeon_directional_helper/north,
/turf/open/floor/naturalstone,
/area/rogue/under/cave)
"u" = (
/obj/structure/mineral_door/wood/green,
/turf/open/floor/naturalstone,
/area/rogue/under/cave)
"x" = (
/mob/living/carbon/human/species/skeleton/npc/ambush,
/turf/open/floor/ruinedwood/spiral,
/area/rogue/under/cave)
"y" = (
/turf/open/floor/dirt,
/area/rogue/under/cave)
"z" = (
/mob/living/carbon/human/species/skeleton/npc/ambush,
/turf/open/floor/dirt,
/area/rogue/under/cave)
"C" = (
/mob/living/carbon/human/species/skeleton/npc/warrior/skilled,
/turf/open/floor/ruinedwood/spiral,
/area/rogue/under/cave)
"D" = (
/mob/living/carbon/human/species/skeleton/npc/warrior,
/turf/open/floor/ruinedwood/spiral,
/area/rogue/under/cave)
"E" = (
/obj/effect/dungeon_directional_helper/south,
/turf/open/floor/naturalstone,
/area/rogue/under/cave)
"G" = (
/obj/structure/fluff/railing/border{
	dir = 1
	},
/turf/open/transparent/openspace,
/area/rogue/under/cave)
"I" = (
/turf/closed/wall/mineral/wooddark,
/area/rogue/under/cave)
"J" = (
/obj/effect/dungeon_directional_helper/east,
/turf/open/floor/naturalstone,
/area/rogue/under/cave)
"K" = (
/turf/closed/wall/mineral/wooddark/window,
/area/rogue/under/cave)
"L" = (
/obj/effect/decal/cleanable/dirt/cobweb{
	dir = 8
	},
/turf/open/floor/ruinedwood/spiral,
/area/rogue/under/cave)
"M" = (
/obj/structure/bed/wool,
/obj/effect/decal/cleanable/dirt/cobweb/cobweb2,
/turf/open/floor/ruinedwood/spiral,
/area/rogue/under/cave)
"N" = (
/obj/structure/mineral_door/wood/green,
/turf/open/floor/ruinedwood/spiral,
/area/rogue/under/cave)
"O" = (
/obj/structure/fluff/railing/border{
	dir = 8
	},
/turf/open/transparent/openspace,
/area/rogue/under/cave)
"P" = (
/obj/item/bomb{
	pixel_x = 9;
	pixel_y = 17
	},
/obj/item/bomb{
	pixel_x = -1;
	pixel_y = 17
	},
/obj/structure/rack/shelf/big,
/turf/open/floor/ruinedwood/spiral,
/area/rogue/under/cave)
"Q" = (
/obj/structure/fluff/railing/border,
/turf/open/transparent/openspace,
/area/rogue/under/cave)
"S" = (
/obj/structure/rack,
/obj/item/clothing/armor/leather,
/obj/item/clothing/pants/trou/leather{
	pixel_x = 14;
	pixel_y = -4
	},
/obj/item/clothing/wrists/bracers/leather{
	pixel_y = -9;
	pixel_x = -6
	},
/turf/open/floor/ruinedwood/spiral,
/area/rogue/under/cave)
"T" = (
/obj/structure/fluff/buysign,
/obj/structure/fluff/buysign{
	desc = " Store Closed"
	},
/turf/open/floor/naturalstone,
/area/rogue/under/cave)
"U" = (
/obj/structure/fluff/railing/fence,
/turf/open/floor/naturalstone,
/area/rogue/under/cave)
"W" = (
/obj/structure/rack,
/obj/item/weapon/sword/iron{
	pixel_x = 10
	},
/obj/item/weapon/sword/iron{
	pixel_x = 3
	},
/obj/item/weapon/sword/arming{
	pixel_y = 3;
	pixel_x = -1
	},
/turf/open/floor/ruinedwood/spiral,
/area/rogue/under/cave)
"X" = (
/obj/structure/fluff/railing/border{
	dir = 9
	},
/turf/open/transparent/openspace,
/area/rogue/under/cave)
"Y" = (
/obj/structure/fluff/railing/border{
	dir = 10
	},
/turf/open/transparent/openspace,
/area/rogue/under/cave)
"Z" = (
/obj/structure/table/wood/counter/end{
	dir = 8
	},
/turf/open/floor/ruinedwood/spiral,
/area/rogue/under/cave)

(1,1,1) = {"
a
a
a
a
a
a
a
a
a
a
a
a
a
a
a
"}
(2,1,1) = {"
a
p
p
p
I
P
W
k
S
g
I
p
p
p
a
"}
(3,1,1) = {"
a
p
p
a
I
l
l
x
l
l
I
a
p
p
a
"}
(4,1,1) = {"
a
p
p
a
I
l
n
h
h
Z
I
a
a
p
a
"}
(5,1,1) = {"
a
a
p
p
I
l
l
l
l
L
I
a
a
p
a
"}
(6,1,1) = {"
p
p
p
p
I
y
K
u
K
I
I
p
p
p
p
"}
(7,1,1) = {"
p
p
p
y
c
y
y
j
z
y
c
y
y
y
p
"}
(8,1,1) = {"
t
p
p
y
j
j
j
j
j
j
j
j
j
y
E
"}
(9,1,1) = {"
p
p
p
y
c
y
z
j
y
y
c
y
y
y
p
"}
(10,1,1) = {"
p
p
T
p
U
y
y
s
y
z
c
p
p
p
p
"}
(11,1,1) = {"
a
a
a
a
a
f
f
j
f
f
a
a
p
a
a
"}
(12,1,1) = {"
a
a
a
a
p
p
y
j
y
p
p
a
p
a
a
"}
(13,1,1) = {"
a
a
p
p
p
p
y
y
y
p
p
a
p
p
a
"}
(14,1,1) = {"
a
a
a
p
p
p
p
p
p
p
p
a
a
a
a
"}
(15,1,1) = {"
a
a
a
a
a
p
p
J
p
p
a
a
a
a
a
"}

(1,1,2) = {"
a
a
a
a
a
a
a
a
a
a
a
a
a
a
a
"}
(2,1,2) = {"
a
p
p
p
I
q
l
l
l
g
I
a
p
p
a
"}
(3,1,2) = {"
a
p
p
p
I
r
D
l
l
l
I
p
p
p
a
"}
(4,1,2) = {"
a
p
p
a
I
M
l
l
C
d
I
a
a
p
a
"}
(5,1,2) = {"
a
p
a
a
I
I
K
N
K
I
I
a
a
p
a
"}
(6,1,2) = {"
p
p
e
Q
l
l
l
x
l
l
l
G
e
p
p
"}
(7,1,2) = {"
p
e
e
Y
O
O
O
e
O
O
O
X
e
e
p
"}
(8,1,2) = {"
p
e
e
e
e
e
e
e
e
e
e
e
e
e
p
"}
(9,1,2) = {"
p
e
e
e
e
e
e
e
e
e
e
e
e
e
p
"}
(10,1,2) = {"
p
e
e
e
e
e
e
e
e
e
e
e
e
e
p
"}
(11,1,2) = {"
a
a
a
a
a
e
e
e
e
e
a
a
e
a
a
"}
(12,1,2) = {"
a
a
a
a
e
e
e
e
e
e
e
e
e
a
a
"}
(13,1,2) = {"
a
a
e
e
e
e
e
e
e
e
e
a
e
e
a
"}
(14,1,2) = {"
a
a
a
e
e
e
e
e
e
e
e
a
a
a
a
"}
(15,1,2) = {"
a
a
a
a
a
p
p
p
p
p
a
a
a
a
a
"}
