//MAP CONVERTED BY dmm2tgm.py THIS HEADER COMMENT PREVENTS RECONVERSION, DO NOT REMOVE
"cy" = (
/obj/effect/decal/cleanable/sigil/NE,
/turf/open/floor/ruinedwood/spiral,
/area/rogue/under/tomb/indoors)
"cA" = (
/obj/effect/decal/cleanable/sigil/SW,
/turf/open/floor/ruinedwood/spiral,
/area/rogue/under/tomb/indoors)
"dx" = (
/obj/machinery/light/fueled/wallfire/candle/blue,
/obj/structure/table/vtable,
/obj/item/storage/belt/pouch,
/turf/open/floor/ruinedwood/spiral,
/area/rogue/under/tomb/indoors)
"eS" = (
/obj/effect/decal/cleanable/sigil/N,
/obj/machinery/light/fueled/wallfire/candle/blue,
/turf/open/floor/ruinedwood/spiral,
/area/rogue/under/tomb/indoors)
"fo" = (
/obj/structure/bed/inn/double,
/obj/item/bedsheet/fabric_double,
/turf/open/floor/ruinedwood/spiral,
/area/rogue/under/tomb/indoors)
"hc" = (
/obj/structure/door/fancy,
/obj/effect/mapping_helpers/access/locker,
/obj/item/soap/bath{
	pixel_y = -5
	},
/turf/open/floor/ruinedwood/spiral,
/area/rogue/under/tomb/indoors)
"hr" = (
/turf/closed/mineral/bedrock,
/area/rogue/under/tomb/cave/wet)
"ht" = (
/obj/structure/bed/shit,
/turf/open/floor/ruinedwood/spiral,
/area/rogue/under/tomb/indoors)
"hA" = (
/obj/machinery/light/fueled/wallfire/candle/blue/r,
/turf/open/floor/ruinedwood/spiral,
/area/rogue/under/tomb/indoors)
"hL" = (
/mob/living/carbon/human/species/skeleton/npc/ambush,
/turf/open/floor/ruinedwood/spiral,
/area/rogue/under/tomb/indoors)
"hU" = (
/obj/structure/bed/shit,
/obj/item/statue/iron,
/turf/open/floor/ruinedwood/spiral,
/area/rogue/under/tomb/indoors)
"il" = (
/obj/structure/stairs/d,
/turf/open/floor/ruinedwood/spiral,
/area/rogue/under/tomb/indoors)
"io" = (
/turf/open/transparent/openspace,
/area/rogue/under/tomb/indoors)
"iy" = (
/obj/structure/closet/crate/crafted_closet/inn,
/obj/item/statue/silver,
/turf/open/floor/ruinedwood/spiral,
/area/rogue/under/tomb/indoors)
"iO" = (
/obj/effect/decal/cleanable/sigil/W,
/mob/living/carbon/human/species/skeleton/npc/warrior,
/turf/open/floor/ruinedwood/spiral,
/area/rogue/under/tomb/indoors)
"jl" = (
/mob/living/carbon/human/species/skeleton/npc/ambush,
/turf/open/water/bath,
/area/rogue/under/tomb/indoors)
"js" = (
/obj/structure/bed/shit,
/mob/living/carbon/human/species/skeleton/npc/peasant,
/turf/open/floor/ruinedwood/spiral,
/area/rogue/under/tomb/indoors)
"jL" = (
/obj/item/soap/bath{
	pixel_y = -5
	},
/turf/open/water/bath,
/area/rogue/under/tomb/indoors)
"jV" = (
/turf/closed/wall/mineral/decowood,
/area/rogue/under/tomb/indoors)
"jX" = (
/obj/structure/door/fancy,
/obj/effect/mapping_helpers/access/locker,
/turf/open/floor/ruinedwood/spiral,
/area/rogue/under/tomb/indoors)
"kv" = (
/turf/open/water/bath,
/area/rogue/under/tomb/indoors)
"mv" = (
/obj/machinery/light/fueled/wallfire/candle/blue,
/turf/open/water/bath,
/area/rogue/under/tomb/indoors)
"oo" = (
/mob/living/carbon/human/species/skeleton/npc/ambush,
/turf/open/floor/tile,
/area/rogue/under/tomb/indoors)
"oR" = (
/turf/open/water/swamp/deep,
/area/rogue/under/tomb/cave)
"oT" = (
/obj/structure/door/swing,
/turf/open/floor/tile,
/area/rogue/under/tomb/indoors)
"oW" = (
/turf/open/transparent/openspace,
/area/rogue/under/tomb/cave/wet)
"px" = (
/obj/structure/stairs,
/turf/open/floor/tile,
/area/rogue/under/tomb/indoors)
"qU" = (
/obj/effect/decal/cleanable/sigil,
/obj/item/reagent_containers/powder/ozium{
	pixel_y = 2
	},
/obj/item/reagent_containers/powder/ozium{
	pixel_y = 15;
	pixel_x = -19
	},
/obj/item/reagent_containers/powder/ozium{
	pixel_y = 23
	},
/obj/item/reagent_containers/powder/ozium{
	pixel_y = 14;
	pixel_x = 21
	},
/obj/item/reagent_containers/powder/ozium{
	pixel_y = -12;
	pixel_x = -13
	},
/obj/item/reagent_containers/powder/ozium{
	pixel_y = -13;
	pixel_x = 14
	},
/turf/open/floor/ruinedwood/spiral,
/area/rogue/under/tomb/indoors)
"qZ" = (
/obj/structure/rack/shelf/big,
/obj/item/perfume/random{
	pixel_y = 24
	},
/obj/item/perfume/random{
	pixel_y = 24;
	pixel_x = 12
	},
/turf/open/floor/ruinedwood/spiral,
/area/rogue/under/tomb/indoors)
"rz" = (
/turf/open/floor/ruinedwood/spiral,
/area/rogue/under/tomb/indoors)
"tg" = (
/obj/effect/decal/cleanable/sigil/SE,
/turf/open/floor/ruinedwood/spiral,
/area/rogue/under/tomb/indoors)
"ug" = (
/turf/open/floor/naturalstone,
/area/rogue/under/tomb/cave/wet)
"uv" = (
/obj/structure/table/vtable,
/obj/item/weapon/knife/dagger/silver{
	pixel_y = 8;
	pixel_x = 6
	},
/turf/open/floor/ruinedwood/spiral,
/area/rogue/under/tomb/indoors)
"xm" = (
/obj/structure/rack/shelf/big,
/obj/item/perfume/random{
	pixel_y = 25
	},
/obj/item/perfume/random{
	pixel_y = 27;
	pixel_x = 13
	},
/turf/open/floor/ruinedwood/spiral,
/area/rogue/under/tomb/indoors)
"yB" = (
/obj/machinery/light/fueled/wallfire/candle/blue/l,
/turf/open/floor/ruinedwood/spiral,
/area/rogue/under/tomb/indoors)
"yX" = (
/obj/effect/dungeon_directional_helper/west,
/turf/open/floor/dirt,
/area/rogue/under/tomb/cave/wet)
"AD" = (
/obj/machinery/light/fueled/wallfire/candle/blue,
/obj/structure/bed/shit,
/turf/open/floor/ruinedwood/spiral,
/area/rogue/under/tomb/indoors)
"Be" = (
/turf/open/water/swamp/deep,
/area/rogue/under/tomb/cave/wet)
"Cj" = (
/obj/item/statue/steel,
/turf/open/floor/tile,
/area/rogue/under/tomb/indoors)
"Cy" = (
/obj/effect/dungeon_directional_helper/north,
/turf/open/floor/dirt,
/area/rogue/under/tomb/cave/wet)
"CB" = (
/mob/living/carbon/human/species/skeleton/npc/warrior/skilled,
/turf/open/floor/ruinedwood/spiral,
/area/rogue/under/tomb/indoors)
"Dh" = (
/turf/open/floor/rooftop{
	dir = 1
	},
/area/rogue/under/tomb/cave/wet)
"Ff" = (
/obj/item/soap{
	pixel_x = -3;
	pixel_y = -5
	},
/obj/structure/door/swing,
/turf/open/floor/ruinedwood/spiral,
/area/rogue/under/tomb/indoors)
"Fy" = (
/mob/living/carbon/human/species/skeleton/npc/ambush,
/turf/open/water/swamp/deep,
/area/rogue/under/tomb/cave)
"FC" = (
/turf/open/floor/dirt,
/area/rogue/under/tomb/cave/wet)
"Gb" = (
/obj/item/soap/bath{
	pixel_y = -5
	},
/mob/living/carbon/human/species/skeleton/npc/ambush,
/turf/open/water/bath,
/area/rogue/under/tomb/indoors)
"Gm" = (
/turf/open/floor/tile,
/area/rogue/under/tomb/indoors)
"Ha" = (
/turf/open/floor/rooftop{
	dir = 4
	},
/area/rogue/under/tomb/cave/wet)
"If" = (
/obj/structure/door/swing,
/obj/item/soap/bath{
	pixel_y = -5
	},
/turf/open/floor/tile,
/area/rogue/under/tomb/indoors)
"Ii" = (
/turf/closed/indestructible/roguewindow,
/area/rogue/under/tomb/indoors)
"Iq" = (
/turf/open/floor/rooftop,
/area/rogue/under/tomb/cave/wet)
"IM" = (
/obj/effect/decal/cleanable/sigil/E,
/turf/open/floor/ruinedwood/spiral,
/area/rogue/under/tomb/indoors)
"JE" = (
/turf/closed/wall/mineral/decowood/vert,
/area/rogue/under/tomb/indoors)
"JH" = (
/obj/structure/rack/shelf/big,
/obj/item/perfume/random{
	pixel_y = 24
	},
/obj/item/perfume/random{
	pixel_x = 12;
	pixel_y = 27
	},
/turf/open/floor/ruinedwood/spiral,
/area/rogue/under/tomb/indoors)
"JN" = (
/obj/item/gem/violet,
/turf/open/water/bath,
/area/rogue/under/tomb/indoors)
"Kf" = (
/obj/machinery/light/fueled/wallfire/candle/blue,
/obj/structure/closet/crate/drawer/inn,
/turf/open/floor/ruinedwood/spiral,
/area/rogue/under/tomb/indoors)
"LC" = (
/mob/living/carbon/human/species/skeleton/npc/peasant,
/turf/open/floor/ruinedwood/spiral,
/area/rogue/under/tomb/indoors)
"LO" = (
/obj/effect/decal/cleanable/sigil/S,
/turf/open/floor/ruinedwood/spiral,
/area/rogue/under/tomb/indoors)
"Nh" = (
/obj/machinery/light/fueled/wallfire/candle/blue,
/obj/structure/closet/crate/drawer/inn,
/obj/item/gem/blue,
/turf/open/floor/ruinedwood/spiral,
/area/rogue/under/tomb/indoors)
"Pk" = (
/mob/living/carbon/human/species/zizombie/npc/militiamen,
/obj/item/clothing/ring/gold/gemerald,
/obj/effect/mapping_helpers/floor_clothing_equipper,
/turf/open/floor/ruinedwood/spiral,
/area/rogue/under/tomb/indoors)
"Px" = (
/mob/living/carbon/human/species/skeleton/npc/warrior,
/turf/open/floor/ruinedwood/spiral,
/area/rogue/under/tomb/indoors)
"RE" = (
/obj/structure/table/vtable/v2,
/obj/item/weapon/knife/dagger/silver{
	pixel_y = 3;
	pixel_x = -3
	},
/obj/item/reagent_containers/powder/moondust,
/obj/item/reagent_containers/powder/moondust{
	pixel_y = 10;
	pixel_x = -13
	},
/obj/item/reagent_containers/powder/moondust{
	pixel_y = 10;
	pixel_x = 10
	},
/turf/open/floor/ruinedwood/spiral,
/area/rogue/under/tomb/indoors)
"RU" = (
/obj/effect/decal/cleanable/sigil/NW,
/turf/open/floor/ruinedwood/spiral,
/area/rogue/under/tomb/indoors)
"SC" = (
/obj/item/storage/belt/pouch,
/obj/structure/table/vtable/v2,
/turf/open/floor/ruinedwood/spiral,
/area/rogue/under/tomb/indoors)
"TO" = (
/obj/effect/dungeon_directional_helper/south,
/turf/open/floor/dirt,
/area/rogue/under/tomb/cave/wet)
"WI" = (
/turf/open/floor/rooftop{
	dir = 8
	},
/area/rogue/under/tomb/cave/wet)
"WN" = (
/obj/effect/dungeon_directional_helper/east,
/turf/open/floor/dirt,
/area/rogue/under/tomb/cave/wet)
"Yt" = (
/mob/living/carbon/human/species/skeleton/npc/ambush,
/turf/open/water/swamp/deep,
/area/rogue/under/tomb/cave/wet)
"Zk" = (
/obj/machinery/light/fueled/wallfire/candle/blue,
/obj/structure/rack/shelf/big,
/obj/item/perfume/random{
	pixel_y = 25
	},
/obj/item/perfume/random{
	pixel_y = 23;
	pixel_x = 14
	},
/turf/open/floor/ruinedwood/spiral,
/area/rogue/under/tomb/indoors)
"Zx" = (
/obj/structure/bed/shit,
/obj/item/statue/iron/deformed,
/turf/open/floor/ruinedwood/spiral,
/area/rogue/under/tomb/indoors)
"ZQ" = (
/obj/machinery/light/fueled/wallfire/candle/blue,
/turf/open/floor/tile,
/area/rogue/under/tomb/indoors)

(1,1,1) = {"
hr
hr
hr
hr
hr
hr
hr
hr
hr
yX
FC
hr
hr
hr
hr
hr
hr
hr
hr
hr
"}
(2,1,1) = {"
hr
FC
FC
FC
FC
FC
FC
FC
FC
FC
FC
FC
FC
FC
FC
FC
FC
FC
FC
hr
"}
(3,1,1) = {"
hr
FC
Be
Be
Be
Be
Be
Be
Be
Be
Be
Be
Be
Be
Be
Be
Be
Be
FC
hr
"}
(4,1,1) = {"
hr
FC
Be
JE
JE
JE
JE
JE
JE
Be
Be
JE
JE
JE
JE
JE
JE
Be
FC
hr
"}
(5,1,1) = {"
hr
FC
Be
JE
kv
kv
jL
Gm
oT
Be
Be
oT
Gm
jL
kv
kv
JE
Be
FC
hr
"}
(6,1,1) = {"
hr
FC
Be
JE
Gb
kv
kv
Gm
JE
Be
Be
JE
ZQ
kv
kv
kv
JE
Be
FC
hr
"}
(7,1,1) = {"
hr
FC
Be
JE
mv
kv
kv
Cj
JE
Be
Be
JE
Gm
kv
Gb
kv
JE
Be
FC
hr
"}
(8,1,1) = {"
hr
FC
Be
JE
Gm
Gm
Gm
Gm
JE
Be
Be
JE
Gm
Gm
Gm
Gm
JE
Be
FC
hr
"}
(9,1,1) = {"
hr
FC
Be
JE
If
JE
JE
JE
Gm
oo
Gm
Gm
JE
JE
JE
If
JE
Be
FC
hr
"}
(10,1,1) = {"
FC
FC
Be
Be
Be
Be
Yt
Be
Gm
px
JE
Gm
oR
oR
oR
oR
oR
Be
FC
FC
"}
(11,1,1) = {"
Cy
FC
Be
Be
Be
Be
Be
Be
Gm
px
JE
Gm
oR
Fy
oR
oR
oR
Be
FC
TO
"}
(12,1,1) = {"
hr
FC
Be
JE
oT
JE
JE
JE
Gm
Gm
Gm
Gm
JE
JE
JE
oT
JE
Be
FC
hr
"}
(13,1,1) = {"
hr
FC
Be
JE
Gm
Gm
Gm
Gm
JE
Be
Be
JE
Gm
Gm
Gm
Gm
JE
Be
FC
hr
"}
(14,1,1) = {"
hr
FC
Be
JE
mv
kv
jL
Gm
JE
Be
Be
JE
ZQ
kv
kv
jL
JE
Be
FC
hr
"}
(15,1,1) = {"
hr
FC
Be
JE
kv
kv
jl
Gm
JE
Be
Be
JE
Gm
jL
kv
jl
JE
Be
FC
hr
"}
(16,1,1) = {"
hr
FC
Be
JE
kv
kv
kv
Gm
If
Be
Be
If
Gm
kv
jl
JN
JE
Be
FC
hr
"}
(17,1,1) = {"
hr
FC
Be
JE
JE
JE
JE
JE
JE
Be
Be
JE
JE
JE
JE
JE
JE
Be
FC
hr
"}
(18,1,1) = {"
hr
FC
Be
Be
Be
Be
Be
Be
Be
Be
Be
Be
Be
Be
Be
Be
Be
Be
FC
hr
"}
(19,1,1) = {"
hr
FC
FC
FC
FC
FC
FC
FC
FC
FC
FC
FC
FC
FC
FC
FC
FC
FC
FC
hr
"}
(20,1,1) = {"
hr
hr
hr
hr
hr
hr
hr
hr
hr
WN
FC
hr
hr
hr
hr
hr
hr
hr
hr
hr
"}

(1,1,2) = {"
hr
hr
hr
hr
hr
hr
hr
hr
ug
ug
ug
ug
hr
hr
hr
hr
hr
hr
hr
hr
"}
(2,1,2) = {"
hr
oW
oW
oW
oW
oW
oW
oW
oW
oW
oW
oW
oW
oW
oW
oW
oW
oW
oW
hr
"}
(3,1,2) = {"
hr
oW
oW
WI
WI
WI
WI
WI
WI
WI
WI
WI
WI
WI
WI
WI
WI
oW
oW
hr
"}
(4,1,2) = {"
hr
oW
Dh
jV
jV
jV
jV
jV
jV
jV
jV
jV
jV
jV
jV
jV
jV
Iq
oW
hr
"}
(5,1,2) = {"
hr
oW
Dh
jV
js
rz
Zx
jV
RU
iO
cA
uv
jV
xm
Pk
rz
jV
Iq
oW
hr
"}
(6,1,2) = {"
hr
oW
Dh
jV
AD
LC
ht
jV
eS
qU
LO
SC
jV
Zk
rz
rz
jV
Iq
oW
hr
"}
(7,1,2) = {"
hr
oW
Dh
jV
hU
rz
ht
jV
cy
IM
tg
rz
jV
qZ
rz
rz
jV
Iq
oW
hr
"}
(8,1,2) = {"
hr
oW
Dh
jV
rz
rz
LC
jV
rz
rz
rz
rz
jV
JH
rz
rz
jV
Iq
oW
hr
"}
(9,1,2) = {"
ug
oW
Dh
jV
jV
Ff
jV
jV
rz
rz
rz
rz
jV
jV
hc
jV
jV
Iq
oW
ug
"}
(10,1,2) = {"
ug
oW
Dh
Ii
rz
rz
rz
rz
rz
io
il
rz
hL
yB
rz
rz
Ii
Iq
oW
ug
"}
(11,1,2) = {"
ug
oW
Dh
Ii
rz
rz
rz
rz
rz
io
il
rz
rz
hA
rz
rz
Ii
Iq
oW
ug
"}
(12,1,2) = {"
ug
oW
Dh
jV
jV
jX
jV
jV
rz
rz
rz
rz
jV
jV
jX
jV
jV
Iq
oW
ug
"}
(13,1,2) = {"
hr
oW
Dh
jV
Px
rz
rz
jV
rz
rz
rz
rz
jV
hL
rz
rz
jV
Iq
oW
hr
"}
(14,1,2) = {"
hr
oW
Dh
jV
rz
rz
rz
jV
dx
rz
rz
rz
jV
iy
rz
rz
jV
Iq
oW
hr
"}
(15,1,2) = {"
hr
oW
Dh
jV
Nh
rz
rz
jV
RE
rz
rz
rz
jV
Kf
rz
hL
jV
Iq
oW
hr
"}
(16,1,2) = {"
hr
oW
Dh
jV
fo
rz
CB
jV
Px
rz
rz
rz
jV
fo
rz
rz
jV
Iq
oW
hr
"}
(17,1,2) = {"
hr
oW
Dh
jV
jV
jV
jV
jV
jV
jV
jV
jV
jV
jV
jV
jV
jV
Iq
oW
hr
"}
(18,1,2) = {"
hr
oW
oW
Ha
Ha
Ha
Ha
Ha
Ha
Ha
Ha
Ha
Ha
Ha
Ha
Ha
Ha
oW
oW
hr
"}
(19,1,2) = {"
hr
oW
oW
oW
oW
oW
oW
oW
oW
oW
oW
oW
oW
oW
oW
oW
oW
oW
oW
hr
"}
(20,1,2) = {"
hr
hr
hr
hr
hr
hr
hr
hr
ug
ug
ug
ug
hr
hr
hr
hr
hr
hr
hr
hr
"}
