//MAP CONVERTED BY dmm2tgm.py THIS HEADER COMMENT PREVENTS RECONVERSION, DO NOT REMOVE
"aO" = (
/obj/effect/decal/cleanable/sigil/N,
/obj/machinery/light/fueled/wallfire/candle/blue,
/turf/open/floor/ruinedwood/spiral,
/area/rogue/indoors/shelter)
"aY" = (
/obj/machinery/light/fueled/wallfire/candle/blue,
/obj/structure/table/vtable,
/obj/item/storage/belt/pouch,
/turf/open/floor/ruinedwood/spiral,
/area/rogue/indoors/shelter)
"bv" = (
/turf/open/floor/rooftop{
	dir = 4
	},
/area/rogue/under/cave)
"bO" = (
/obj/item/bath/soap{
	pixel_y = -5
	},
/obj/structure/mineral_door/wood/fancywood{
	locked = 1
	},
/turf/open/floor/ruinedwood/spiral,
/area/rogue/indoors/shelter)
"cO" = (
/obj/item/statue/steel,
/turf/open/floor/tile,
/area/rogue/under/cavewet)
"cV" = (
/turf/open/water/swamp/deep,
/area/rogue/under/cavewet)
"dh" = (
/obj/structure/stairs/d,
/turf/open/floor/ruinedwood/spiral,
/area/rogue/indoors/shelter)
"dT" = (
/obj/effect/decal/cleanable/sigil/NW,
/turf/open/floor/ruinedwood/spiral,
/area/rogue/indoors/shelter)
"gI" = (
/obj/structure/stairs,
/turf/open/floor/tile,
/area/rogue/under/cavewet)
"hR" = (
/obj/machinery/light/fueled/wallfire/candle/blue/r,
/turf/open/floor/ruinedwood/spiral,
/area/rogue/indoors/shelter)
"iZ" = (
/obj/effect/dungeon_directional_helper/north,
/turf/open/floor/dirt,
/area/rogue/under/cave)
"kc" = (
/obj/item/bath/soap{
	pixel_y = -5
	},
/turf/open/water/bath,
/area/rogue/under/cavewet)
"kJ" = (
/mob/living/carbon/human/species/skeleton/npc/ambush,
/turf/open/water/bath,
/area/rogue/under/cavewet)
"mh" = (
/obj/structure/closet/crate/crafted_closet/inn,
/obj/item/statue/silver,
/turf/open/floor/ruinedwood/spiral,
/area/rogue/indoors/shelter)
"mx" = (
/obj/effect/decal/cleanable/sigil/SW,
/turf/open/floor/ruinedwood/spiral,
/area/rogue/indoors/shelter)
"mF" = (
/turf/open/floor/dirt,
/area/rogue/under/cave)
"nn" = (
/turf/open/floor/ruinedwood/spiral,
/area/rogue/indoors/shelter)
"nu" = (
/turf/open/floor/rooftop{
	dir = 8
	},
/area/rogue/under/cave)
"nx" = (
/obj/machinery/light/fueled/wallfire/candle/blue,
/obj/structure/rack/shelf/big,
/obj/item/perfume/random{
	pixel_y = 25
	},
/obj/item/perfume/random{
	pixel_y = 23;
	pixel_x = 14
	},
/turf/open/floor/ruinedwood/spiral,
/area/rogue/indoors/shelter)
"oY" = (
/obj/structure/mineral_door/swing_door,
/obj/item/bath/soap{
	pixel_y = -5
	},
/turf/open/floor/tile,
/area/rogue/under/cavewet)
"pA" = (
/obj/structure/rack/shelf/big,
/obj/item/perfume/random{
	pixel_y = 24
	},
/obj/item/perfume/random{
	pixel_y = 24;
	pixel_x = 12
	},
/turf/open/floor/ruinedwood/spiral,
/area/rogue/indoors/shelter)
"pQ" = (
/obj/effect/decal/cleanable/sigil/W,
/mob/living/carbon/human/species/skeleton/npc/warrior,
/turf/open/floor/ruinedwood/spiral,
/area/rogue/indoors/shelter)
"pR" = (
/mob/living/carbon/human/species/skeleton/npc/peasant,
/turf/open/floor/ruinedwood/spiral,
/area/rogue/indoors/shelter)
"rS" = (
/obj/item/soap{
	pixel_x = -3;
	pixel_y = -5
	},
/obj/structure/mineral_door/swing_door,
/turf/open/floor/ruinedwood/spiral,
/area/rogue/indoors/shelter)
"sm" = (
/mob/living/carbon/human/species/skeleton/npc/ambush,
/turf/open/floor/ruinedwood/spiral,
/area/rogue/indoors/shelter)
"tE" = (
/obj/effect/dungeon_directional_helper/west,
/turf/open/floor/dirt,
/area/rogue/under/cave)
"tJ" = (
/obj/structure/rack/shelf/big,
/obj/item/perfume/random{
	pixel_y = 24
	},
/obj/item/perfume/random{
	pixel_x = 12;
	pixel_y = 27
	},
/turf/open/floor/ruinedwood/spiral,
/area/rogue/indoors/shelter)
"tT" = (
/obj/machinery/light/fueled/wallfire/candle/blue,
/obj/structure/closet/crate/drawer/inn,
/turf/open/floor/ruinedwood/spiral,
/area/rogue/indoors/shelter)
"uR" = (
/turf/open/floor/rooftop{
	dir = 1
	},
/area/rogue/under/cave)
"vx" = (
/turf/open/floor/tile,
/area/rogue/under/cavewet)
"wy" = (
/mob/living/carbon/human/species/skeleton/npc/ambush,
/turf/open/water/swamp/deep,
/area/rogue/under/cavewet)
"wQ" = (
/obj/effect/decal/cleanable/sigil/E,
/turf/open/floor/ruinedwood/spiral,
/area/rogue/indoors/shelter)
"xx" = (
/turf/open/transparent/openspace,
/area/rogue/indoors/shelter)
"xY" = (
/mob/living/carbon/human/species/skeleton/npc/ambush,
/turf/open/floor/tile,
/area/rogue/under/cavewet)
"zi" = (
/obj/structure/bed/shit,
/obj/item/statue/iron,
/turf/open/floor/ruinedwood/spiral,
/area/rogue/indoors/shelter)
"zv" = (
/obj/structure/bed/shit,
/mob/living/carbon/human/species/skeleton/npc/peasant,
/turf/open/floor/ruinedwood/spiral,
/area/rogue/indoors/shelter)
"Ao" = (
/obj/machinery/light/fueled/wallfire/candle/blue,
/obj/structure/closet/crate/drawer/inn,
/obj/item/gem/blue,
/turf/open/floor/ruinedwood/spiral,
/area/rogue/indoors/shelter)
"AL" = (
/obj/effect/dungeon_directional_helper/east,
/turf/open/floor/dirt,
/area/rogue/under/cave)
"Bd" = (
/mob/living/carbon/human/species/skeleton/npc/warrior/skilled,
/turf/open/floor/ruinedwood/spiral,
/area/rogue/indoors/shelter)
"BX" = (
/obj/item/gem/violet,
/turf/open/water/bath,
/area/rogue/under/cavewet)
"CA" = (
/obj/item/storage/belt/pouch,
/obj/structure/table/vtable/v2,
/turf/open/floor/ruinedwood/spiral,
/area/rogue/indoors/shelter)
"CU" = (
/obj/effect/decal/cleanable/sigil/S,
/turf/open/floor/ruinedwood/spiral,
/area/rogue/indoors/shelter)
"Ey" = (
/turf/closed/wall/mineral/decowood,
/area/rogue/indoors/shelter)
"EQ" = (
/obj/structure/table/vtable,
/obj/item/weapon/knife/dagger/silver{
	pixel_y = 8;
	pixel_x = 6
	},
/turf/open/floor/ruinedwood/spiral,
/area/rogue/indoors/shelter)
"Fc" = (
/obj/effect/dungeon_directional_helper/south,
/turf/open/floor/dirt,
/area/rogue/under/cave)
"Fx" = (
/obj/structure/bed/inn/double,
/obj/item/bedsheet/fabric_double,
/turf/open/floor/ruinedwood/spiral,
/area/rogue/indoors/shelter)
"FL" = (
/obj/effect/decal/cleanable/sigil/NE,
/turf/open/floor/ruinedwood/spiral,
/area/rogue/indoors/shelter)
"Gb" = (
/obj/structure/mineral_door/wood/fancywood{
	locked = 1
	},
/turf/open/floor/ruinedwood/spiral,
/area/rogue/indoors/shelter)
"Gp" = (
/mob/living/carbon/human/species/skeleton/npc/warrior,
/turf/open/floor/ruinedwood/spiral,
/area/rogue/indoors/shelter)
"Hv" = (
/obj/structure/mineral_door/swing_door,
/turf/open/floor/tile,
/area/rogue/under/cavewet)
"JI" = (
/turf/open/water/swamp/deep,
/area/rogue/under/cave)
"Ko" = (
/obj/machinery/light/fueled/wallfire/candle/blue,
/obj/structure/bed/shit,
/turf/open/floor/ruinedwood/spiral,
/area/rogue/indoors/shelter)
"KT" = (
/obj/structure/rack/shelf/big,
/obj/item/perfume/random{
	pixel_y = 25
	},
/obj/item/perfume/random{
	pixel_y = 27;
	pixel_x = 13
	},
/turf/open/floor/ruinedwood/spiral,
/area/rogue/indoors/shelter)
"Mj" = (
/obj/machinery/light/fueled/wallfire/candle/blue,
/turf/open/water/bath,
/area/rogue/under/cavewet)
"Pa" = (
/obj/structure/bed/shit,
/obj/item/statue/iron/deformed,
/turf/open/floor/ruinedwood/spiral,
/area/rogue/indoors/shelter)
"Ph" = (
/obj/structure/table/vtable/v2,
/obj/item/weapon/knife/dagger/silver{
	pixel_y = 3;
	pixel_x = -3
	},
/obj/item/reagent_containers/powder/moondust,
/obj/item/reagent_containers/powder/moondust{
	pixel_y = 10;
	pixel_x = -13
	},
/obj/item/reagent_containers/powder/moondust{
	pixel_y = 10;
	pixel_x = 10
	},
/turf/open/floor/ruinedwood/spiral,
/area/rogue/indoors/shelter)
"PM" = (
/obj/effect/decal/cleanable/sigil,
/obj/item/reagent_containers/powder/ozium{
	pixel_y = 2
	},
/obj/item/reagent_containers/powder/ozium{
	pixel_y = 15;
	pixel_x = -19
	},
/obj/item/reagent_containers/powder/ozium{
	pixel_y = 23
	},
/obj/item/reagent_containers/powder/ozium{
	pixel_y = 14;
	pixel_x = 21
	},
/obj/item/reagent_containers/powder/ozium{
	pixel_y = -12;
	pixel_x = -13
	},
/obj/item/reagent_containers/powder/ozium{
	pixel_y = -13;
	pixel_x = 14
	},
/turf/open/floor/ruinedwood/spiral,
/area/rogue/indoors/shelter)
"PQ" = (
/obj/machinery/light/fueled/wallfire/candle/blue/l,
/turf/open/floor/ruinedwood/spiral,
/area/rogue/indoors/shelter)
"Qs" = (
/obj/effect/decal/cleanable/sigil/SE,
/turf/open/floor/ruinedwood/spiral,
/area/rogue/indoors/shelter)
"Qw" = (
/turf/open/floor/naturalstone,
/area/rogue/under/cave)
"RG" = (
/turf/closed/mineral/bedrock,
/area/rogue/under/cave)
"TQ" = (
/turf/open/transparent/openspace,
/area/rogue/under/cave)
"UB" = (
/obj/item/bath/soap{
	pixel_y = -5
	},
/mob/living/carbon/human/species/skeleton/npc/ambush,
/turf/open/water/bath,
/area/rogue/under/cavewet)
"UT" = (
/turf/open/water/bath,
/area/rogue/under/cavewet)
"Vw" = (
/mob/living/carbon/human/species/zizombie/npc/militiamen,
/obj/item/clothing/ring/gold/gemerald,
/obj/effect/mapping_helpers/floor_clothing_equipper,
/turf/open/floor/ruinedwood/spiral,
/area/rogue/indoors/shelter)
"Yr" = (
/turf/open/floor/rooftop,
/area/rogue/under/cave)
"Yy" = (
/obj/machinery/light/fueled/wallfire/candle/blue,
/turf/open/floor/tile,
/area/rogue/under/cavewet)
"YP" = (
/obj/structure/bed/shit,
/turf/open/floor/ruinedwood/spiral,
/area/rogue/indoors/shelter)
"YZ" = (
/turf/closed/wall/mineral/decowood/vert,
/area/rogue/under/cavewet)
"Zi" = (
/turf/closed/indestructible/roguewindow,
/area/rogue/indoors/shelter)

(1,1,1) = {"
RG
RG
RG
RG
RG
RG
RG
RG
RG
tE
mF
RG
RG
RG
RG
RG
RG
RG
RG
RG
"}
(2,1,1) = {"
RG
mF
mF
mF
mF
mF
mF
mF
mF
mF
mF
mF
mF
mF
mF
mF
mF
mF
mF
RG
"}
(3,1,1) = {"
RG
mF
JI
JI
JI
JI
JI
JI
JI
JI
JI
JI
JI
JI
JI
JI
JI
JI
mF
RG
"}
(4,1,1) = {"
RG
mF
JI
YZ
YZ
YZ
YZ
YZ
YZ
cV
cV
YZ
YZ
YZ
YZ
YZ
YZ
JI
mF
RG
"}
(5,1,1) = {"
RG
mF
JI
YZ
UT
UT
kc
vx
Hv
cV
cV
Hv
vx
kc
UT
UT
YZ
JI
mF
RG
"}
(6,1,1) = {"
RG
mF
JI
YZ
UB
UT
UT
vx
YZ
cV
cV
YZ
Yy
UT
UT
UT
YZ
JI
mF
RG
"}
(7,1,1) = {"
RG
mF
JI
YZ
Mj
UT
UT
cO
YZ
cV
cV
YZ
vx
UT
UB
UT
YZ
JI
mF
RG
"}
(8,1,1) = {"
RG
mF
JI
YZ
vx
vx
vx
vx
YZ
cV
cV
YZ
vx
vx
vx
vx
YZ
JI
mF
RG
"}
(9,1,1) = {"
RG
mF
JI
YZ
oY
YZ
YZ
YZ
vx
xY
vx
vx
YZ
YZ
YZ
oY
YZ
JI
mF
RG
"}
(10,1,1) = {"
mF
mF
JI
cV
cV
cV
wy
cV
vx
gI
YZ
vx
cV
cV
cV
cV
cV
JI
mF
mF
"}
(11,1,1) = {"
iZ
mF
JI
cV
cV
cV
cV
cV
vx
gI
YZ
vx
cV
wy
cV
cV
cV
JI
mF
Fc
"}
(12,1,1) = {"
RG
mF
JI
YZ
Hv
YZ
YZ
YZ
vx
vx
vx
vx
YZ
YZ
YZ
Hv
YZ
JI
mF
RG
"}
(13,1,1) = {"
RG
mF
JI
YZ
vx
vx
vx
vx
YZ
cV
cV
YZ
vx
vx
vx
vx
YZ
JI
mF
RG
"}
(14,1,1) = {"
RG
mF
JI
YZ
Mj
UT
kc
vx
YZ
cV
cV
YZ
Yy
UT
UT
kc
YZ
JI
mF
RG
"}
(15,1,1) = {"
RG
mF
JI
YZ
UT
UT
kJ
vx
YZ
cV
cV
YZ
vx
kc
UT
kJ
YZ
JI
mF
RG
"}
(16,1,1) = {"
RG
mF
JI
YZ
UT
UT
UT
vx
oY
cV
cV
oY
vx
UT
kJ
BX
YZ
JI
mF
RG
"}
(17,1,1) = {"
RG
mF
JI
YZ
YZ
YZ
YZ
YZ
YZ
cV
cV
YZ
YZ
YZ
YZ
YZ
YZ
JI
mF
RG
"}
(18,1,1) = {"
RG
mF
JI
JI
JI
JI
JI
JI
JI
JI
JI
JI
JI
JI
JI
JI
JI
JI
mF
RG
"}
(19,1,1) = {"
RG
mF
mF
mF
mF
mF
mF
mF
mF
mF
mF
mF
mF
mF
mF
mF
mF
mF
mF
RG
"}
(20,1,1) = {"
RG
RG
RG
RG
RG
RG
RG
RG
RG
AL
mF
RG
RG
RG
RG
RG
RG
RG
RG
RG
"}

(1,1,2) = {"
RG
RG
RG
RG
RG
RG
RG
RG
Qw
Qw
Qw
Qw
RG
RG
RG
RG
RG
RG
RG
RG
"}
(2,1,2) = {"
RG
TQ
TQ
TQ
TQ
TQ
TQ
TQ
TQ
TQ
TQ
TQ
TQ
TQ
TQ
TQ
TQ
TQ
TQ
RG
"}
(3,1,2) = {"
RG
TQ
TQ
nu
nu
nu
nu
nu
nu
nu
nu
nu
nu
nu
nu
nu
nu
TQ
TQ
RG
"}
(4,1,2) = {"
RG
TQ
uR
Ey
Ey
Ey
Ey
Ey
Ey
Ey
Ey
Ey
Ey
Ey
Ey
Ey
Ey
Yr
TQ
RG
"}
(5,1,2) = {"
RG
TQ
uR
Ey
zv
nn
Pa
Ey
dT
pQ
mx
EQ
Ey
KT
Vw
nn
Ey
Yr
TQ
RG
"}
(6,1,2) = {"
RG
TQ
uR
Ey
Ko
pR
YP
Ey
aO
PM
CU
CA
Ey
nx
nn
nn
Ey
Yr
TQ
RG
"}
(7,1,2) = {"
RG
TQ
uR
Ey
zi
nn
YP
Ey
FL
wQ
Qs
nn
Ey
pA
nn
nn
Ey
Yr
TQ
RG
"}
(8,1,2) = {"
RG
TQ
uR
Ey
nn
nn
pR
Ey
nn
nn
nn
nn
Ey
tJ
nn
nn
Ey
Yr
TQ
RG
"}
(9,1,2) = {"
Qw
TQ
uR
Ey
Ey
rS
Ey
Ey
nn
nn
nn
nn
Ey
Ey
bO
Ey
Ey
Yr
TQ
Qw
"}
(10,1,2) = {"
Qw
TQ
uR
Zi
nn
nn
nn
nn
nn
xx
dh
nn
sm
PQ
nn
nn
Zi
Yr
TQ
Qw
"}
(11,1,2) = {"
Qw
TQ
uR
Zi
nn
nn
nn
nn
nn
xx
dh
nn
nn
hR
nn
nn
Zi
Yr
TQ
Qw
"}
(12,1,2) = {"
Qw
TQ
uR
Ey
Ey
Gb
Ey
Ey
nn
nn
nn
nn
Ey
Ey
Gb
Ey
Ey
Yr
TQ
Qw
"}
(13,1,2) = {"
RG
TQ
uR
Ey
Gp
nn
nn
Ey
nn
nn
nn
nn
Ey
sm
nn
nn
Ey
Yr
TQ
RG
"}
(14,1,2) = {"
RG
TQ
uR
Ey
nn
nn
nn
Ey
aY
nn
nn
nn
Ey
mh
nn
nn
Ey
Yr
TQ
RG
"}
(15,1,2) = {"
RG
TQ
uR
Ey
Ao
nn
nn
Ey
Ph
nn
nn
nn
Ey
tT
nn
sm
Ey
Yr
TQ
RG
"}
(16,1,2) = {"
RG
TQ
uR
Ey
Fx
nn
Bd
Ey
Gp
nn
nn
nn
Ey
Fx
nn
nn
Ey
Yr
TQ
RG
"}
(17,1,2) = {"
RG
TQ
uR
Ey
Ey
Ey
Ey
Ey
Ey
Ey
Ey
Ey
Ey
Ey
Ey
Ey
Ey
Yr
TQ
RG
"}
(18,1,2) = {"
RG
TQ
TQ
bv
bv
bv
bv
bv
bv
bv
bv
bv
bv
bv
bv
bv
bv
TQ
TQ
RG
"}
(19,1,2) = {"
RG
TQ
TQ
TQ
TQ
TQ
TQ
TQ
TQ
TQ
TQ
TQ
TQ
TQ
TQ
TQ
TQ
TQ
TQ
RG
"}
(20,1,2) = {"
RG
RG
RG
RG
RG
RG
RG
RG
Qw
Qw
Qw
Qw
RG
RG
RG
RG
RG
RG
RG
RG
"}
