//MAP CONVERTED BY dmm2tgm.py THIS HEADER COMMENT PREVENTS RECONVERSION, DO NOT REMOVE
"bm" = (
/mob/living/carbon/human/species/skeleton/npc/warrior,
/turf/open/floor/ruinedwood/spiral,
/area/rogue/under/tomb/indoors)
"bN" = (
/obj/structure/door/swing,
/obj/item/soap/bath{
	pixel_y = -5
	},
/turf/open/floor/tile,
/area/rogue/under/tomb/indoors)
"cp" = (
/obj/machinery/light/fueled/wallfire/candle/blue/r,
/turf/open/floor/ruinedwood/spiral,
/area/rogue/under/tomb/indoors)
"cD" = (
/obj/item/soap/bath{
	pixel_y = -5
	},
/turf/open/water/bath,
/area/rogue/under/tomb/indoors)
"cM" = (
/turf/open/water/swamp/deep,
/area/rogue/under/tomb/cave/wet)
"em" = (
/obj/machinery/light/fueled/wallfire/candle/blue,
/obj/structure/rack/shelf/big,
/obj/item/perfume/random{
	pixel_y = 25
	},
/obj/item/perfume/random{
	pixel_y = 23;
	pixel_x = 14
	},
/turf/open/floor/ruinedwood/spiral,
/area/rogue/under/tomb/indoors)
"eA" = (
/turf/open/floor/naturalstone,
/area/rogue/under/tomb/cave/wet)
"fU" = (
/obj/machinery/light/fueled/wallfire/candle/blue,
/obj/structure/closet/crate/drawer/inn,
/obj/item/gem/blue,
/turf/open/floor/ruinedwood/spiral,
/area/rogue/under/tomb/indoors)
"ic" = (
/obj/structure/stairs,
/turf/open/floor/tile,
/area/rogue/under/tomb/indoors)
"jQ" = (
/obj/structure/door/fancy,
/obj/effect/mapping_helpers/door/locker,
/turf/open/floor/ruinedwood/spiral,
/area/rogue/under/tomb/indoors)
"kF" = (
/obj/item/storage/belt/pouch,
/obj/structure/table/vtable/v2,
/turf/open/floor/ruinedwood/spiral,
/area/rogue/under/tomb/indoors)
"kM" = (
/obj/machinery/light/fueled/wallfire/candle/blue/l,
/turf/open/floor/ruinedwood/spiral,
/area/rogue/under/tomb/indoors)
"lY" = (
/obj/machinery/light/fueled/wallfire/candle/blue,
/turf/open/floor/tile,
/area/rogue/under/tomb/indoors)
"mY" = (
/mob/living/carbon/human/species/skeleton/npc/warrior/skilled,
/turf/open/floor/ruinedwood/spiral,
/area/rogue/under/tomb/indoors)
"nk" = (
/obj/item/soap/bath{
	pixel_y = -5
	},
/mob/living/carbon/human/species/skeleton/npc/ambush,
/turf/open/water/bath,
/area/rogue/under/tomb/indoors)
"nv" = (
/obj/structure/bed/shit,
/mob/living/carbon/human/species/skeleton/npc/peasant,
/turf/open/floor/ruinedwood/spiral,
/area/rogue/under/tomb/indoors)
"og" = (
/turf/open/transparent/openspace,
/area/rogue/under/tomb/cave/wet)
"ql" = (
/obj/structure/closet/crate/crafted_closet/inn,
/obj/item/statue/silver,
/turf/open/floor/ruinedwood/spiral,
/area/rogue/under/tomb/indoors)
"re" = (
/mob/living/carbon/human/species/skeleton/npc/peasant,
/turf/open/floor/ruinedwood/spiral,
/area/rogue/under/tomb/indoors)
"ry" = (
/obj/machinery/light/fueled/wallfire/candle/blue,
/turf/open/water/bath,
/area/rogue/under/tomb/indoors)
"rU" = (
/obj/effect/dungeon_directional_helper/west,
/turf/open/floor/dirt,
/area/rogue/under/tomb/cave/wet)
"sM" = (
/obj/effect/dungeon_directional_helper/north,
/turf/open/floor/dirt,
/area/rogue/under/tomb/cave/wet)
"sX" = (
/turf/open/floor/rooftop{
	dir = 8
	},
/area/rogue/under/tomb/cave/wet)
"tt" = (
/turf/open/water/bath,
/area/rogue/under/tomb/indoors)
"uH" = (
/obj/item/gem/violet,
/turf/open/water/bath,
/area/rogue/under/tomb/indoors)
"vu" = (
/obj/machinery/light/fueled/wallfire/candle/blue,
/obj/structure/table/vtable,
/obj/item/storage/belt/pouch,
/turf/open/floor/ruinedwood/spiral,
/area/rogue/under/tomb/indoors)
"xd" = (
/obj/effect/decal/cleanable/sigil/SW,
/turf/open/floor/ruinedwood/spiral,
/area/rogue/under/tomb/indoors)
"xN" = (
/obj/structure/door/swing,
/turf/open/floor/tile,
/area/rogue/under/tomb/indoors)
"yT" = (
/obj/structure/bed/shit,
/obj/item/statue/iron/deformed,
/turf/open/floor/ruinedwood/spiral,
/area/rogue/under/tomb/indoors)
"ze" = (
/turf/open/floor/rooftop,
/area/rogue/under/tomb/cave/wet)
"zA" = (
/obj/effect/decal/cleanable/sigil,
/obj/item/reagent_containers/powder/ozium{
	pixel_y = 2
	},
/obj/item/reagent_containers/powder/ozium{
	pixel_y = 15;
	pixel_x = -19
	},
/obj/item/reagent_containers/powder/ozium{
	pixel_y = 23
	},
/obj/item/reagent_containers/powder/ozium{
	pixel_y = 14;
	pixel_x = 21
	},
/obj/item/reagent_containers/powder/ozium{
	pixel_y = -12;
	pixel_x = -13
	},
/obj/item/reagent_containers/powder/ozium{
	pixel_y = -13;
	pixel_x = 14
	},
/turf/open/floor/ruinedwood/spiral,
/area/rogue/under/tomb/indoors)
"zB" = (
/obj/effect/decal/cleanable/sigil/W,
/mob/living/carbon/human/species/skeleton/npc/warrior,
/turf/open/floor/ruinedwood/spiral,
/area/rogue/under/tomb/indoors)
"zZ" = (
/obj/machinery/light/fueled/wallfire/candle/blue,
/obj/structure/closet/crate/drawer/inn,
/turf/open/floor/ruinedwood/spiral,
/area/rogue/under/tomb/indoors)
"AO" = (
/obj/machinery/light/fueled/wallfire/candle/blue,
/obj/structure/bed/shit,
/turf/open/floor/ruinedwood/spiral,
/area/rogue/under/tomb/indoors)
"Bk" = (
/obj/effect/decal/cleanable/sigil/NE,
/turf/open/floor/ruinedwood/spiral,
/area/rogue/under/tomb/indoors)
"Bw" = (
/mob/living/carbon/human/species/skeleton/npc/ambush,
/turf/open/water/bath,
/area/rogue/under/tomb/indoors)
"BK" = (
/turf/closed/wall/mineral/decowood/vert,
/area/rogue/under/tomb/indoors)
"Fu" = (
/obj/structure/rack/shelf/big,
/obj/item/perfume/random{
	pixel_y = 25
	},
/obj/item/perfume/random{
	pixel_y = 27;
	pixel_x = 13
	},
/turf/open/floor/ruinedwood/spiral,
/area/rogue/under/tomb/indoors)
"FY" = (
/obj/effect/decal/cleanable/sigil/NW,
/turf/open/floor/ruinedwood/spiral,
/area/rogue/under/tomb/indoors)
"Go" = (
/turf/open/water/swamp/deep,
/area/rogue/under/tomb/cave)
"GE" = (
/obj/effect/decal/cleanable/sigil/SE,
/turf/open/floor/ruinedwood/spiral,
/area/rogue/under/tomb/indoors)
"GY" = (
/obj/structure/rack/shelf/big,
/obj/item/perfume/random{
	pixel_y = 24
	},
/obj/item/perfume/random{
	pixel_y = 24;
	pixel_x = 12
	},
/turf/open/floor/ruinedwood/spiral,
/area/rogue/under/tomb/indoors)
"Hc" = (
/turf/closed/mineral/bedrock,
/area/rogue/under/tomb/cave/wet)
"Ht" = (
/turf/open/transparent/openspace,
/area/rogue/under/tomb/indoors)
"Hy" = (
/obj/effect/decal/cleanable/sigil/S,
/turf/open/floor/ruinedwood/spiral,
/area/rogue/under/tomb/indoors)
"HN" = (
/obj/structure/door/fancy,
/obj/effect/mapping_helpers/door/locker,
/obj/item/soap/bath{
	pixel_y = -5
	},
/turf/open/floor/ruinedwood/spiral,
/area/rogue/under/tomb/indoors)
"IE" = (
/obj/structure/bed/shit,
/turf/open/floor/ruinedwood/spiral,
/area/rogue/under/tomb/indoors)
"Ka" = (
/obj/effect/decal/cleanable/sigil/N,
/obj/machinery/light/fueled/wallfire/candle/blue,
/turf/open/floor/ruinedwood/spiral,
/area/rogue/under/tomb/indoors)
"KB" = (
/obj/effect/dungeon_directional_helper/east,
/turf/open/floor/dirt,
/area/rogue/under/tomb/cave/wet)
"Lh" = (
/obj/effect/dungeon_directional_helper/south,
/turf/open/floor/dirt,
/area/rogue/under/tomb/cave/wet)
"LA" = (
/mob/living/carbon/human/species/skeleton/npc/ambush,
/turf/open/floor/tile,
/area/rogue/under/tomb/indoors)
"LR" = (
/turf/open/floor/rooftop{
	dir = 4
	},
/area/rogue/under/tomb/cave/wet)
"LS" = (
/turf/closed/indestructible/roguewindow,
/area/rogue/under/tomb/indoors)
"MD" = (
/obj/item/statue/steel,
/turf/open/floor/tile,
/area/rogue/under/tomb/indoors)
"Nj" = (
/mob/living/carbon/human/species/skeleton/npc/ambush,
/turf/open/water/swamp/deep,
/area/rogue/under/tomb/cave/wet)
"Np" = (
/obj/structure/rack/shelf/big,
/obj/item/perfume/random{
	pixel_y = 24
	},
/obj/item/perfume/random{
	pixel_x = 12;
	pixel_y = 27
	},
/turf/open/floor/ruinedwood/spiral,
/area/rogue/under/tomb/indoors)
"OT" = (
/mob/living/carbon/human/species/zizombie/npc/militiamen,
/obj/item/clothing/ring/gold/gemerald,
/obj/effect/mapping_helpers/floor_clothing_equipper,
/turf/open/floor/ruinedwood/spiral,
/area/rogue/under/tomb/indoors)
"PH" = (
/obj/structure/table/vtable/v2,
/obj/item/weapon/knife/dagger/silver{
	pixel_y = 3;
	pixel_x = -3
	},
/obj/item/reagent_containers/powder/moondust,
/obj/item/reagent_containers/powder/moondust{
	pixel_y = 10;
	pixel_x = -13
	},
/obj/item/reagent_containers/powder/moondust{
	pixel_y = 10;
	pixel_x = 10
	},
/turf/open/floor/ruinedwood/spiral,
/area/rogue/under/tomb/indoors)
"QJ" = (
/mob/living/carbon/human/species/skeleton/npc/ambush,
/turf/open/floor/ruinedwood/spiral,
/area/rogue/under/tomb/indoors)
"Tc" = (
/obj/structure/stairs/d,
/turf/open/floor/ruinedwood/spiral,
/area/rogue/under/tomb/indoors)
"Tf" = (
/turf/open/floor/dirt,
/area/rogue/under/tomb/cave/wet)
"TJ" = (
/turf/open/floor/rooftop{
	dir = 1
	},
/area/rogue/under/tomb/cave/wet)
"TR" = (
/obj/structure/bed/shit,
/obj/item/statue/iron,
/turf/open/floor/ruinedwood/spiral,
/area/rogue/under/tomb/indoors)
"Ub" = (
/turf/open/floor/tile,
/area/rogue/under/tomb/indoors)
"Vp" = (
/mob/living/carbon/human/species/skeleton/npc/ambush,
/turf/open/water/swamp/deep,
/area/rogue/under/tomb/cave)
"Wj" = (
/obj/item/soap{
	pixel_x = -3;
	pixel_y = -5
	},
/obj/structure/door/swing,
/turf/open/floor/ruinedwood/spiral,
/area/rogue/under/tomb/indoors)
"Wv" = (
/turf/closed/wall/mineral/decowood,
/area/rogue/under/tomb/indoors)
"Xu" = (
/obj/structure/table/vtable,
/obj/item/weapon/knife/dagger/silver{
	pixel_y = 8;
	pixel_x = 6
	},
/turf/open/floor/ruinedwood/spiral,
/area/rogue/under/tomb/indoors)
"XO" = (
/obj/structure/bed/inn/double,
/obj/item/bedsheet/fabric_double,
/turf/open/floor/ruinedwood/spiral,
/area/rogue/under/tomb/indoors)
"ZH" = (
/obj/effect/decal/cleanable/sigil/E,
/turf/open/floor/ruinedwood/spiral,
/area/rogue/under/tomb/indoors)
"ZP" = (
/turf/open/floor/ruinedwood/spiral,
/area/rogue/under/tomb/indoors)

(1,1,1) = {"
Hc
Hc
Hc
Hc
Hc
Hc
Hc
Hc
Hc
rU
Tf
Hc
Hc
Hc
Hc
Hc
Hc
Hc
Hc
Hc
"}
(2,1,1) = {"
Hc
Tf
Tf
Tf
Tf
Tf
Tf
Tf
Tf
Tf
Tf
Tf
Tf
Tf
Tf
Tf
Tf
Tf
Tf
Hc
"}
(3,1,1) = {"
Hc
Tf
cM
cM
cM
cM
cM
cM
cM
cM
cM
cM
cM
cM
cM
cM
cM
cM
Tf
Hc
"}
(4,1,1) = {"
Hc
Tf
cM
BK
BK
BK
BK
BK
BK
cM
cM
BK
BK
BK
BK
BK
BK
cM
Tf
Hc
"}
(5,1,1) = {"
Hc
Tf
cM
BK
tt
tt
cD
Ub
xN
cM
cM
xN
Ub
cD
tt
tt
BK
cM
Tf
Hc
"}
(6,1,1) = {"
Hc
Tf
cM
BK
nk
tt
tt
Ub
BK
cM
cM
BK
lY
tt
tt
tt
BK
cM
Tf
Hc
"}
(7,1,1) = {"
Hc
Tf
cM
BK
ry
tt
tt
MD
BK
cM
cM
BK
Ub
tt
nk
tt
BK
cM
Tf
Hc
"}
(8,1,1) = {"
Hc
Tf
cM
BK
Ub
Ub
Ub
Ub
BK
cM
cM
BK
Ub
Ub
Ub
Ub
BK
cM
Tf
Hc
"}
(9,1,1) = {"
Hc
Tf
cM
BK
bN
BK
BK
BK
Ub
LA
Ub
Ub
BK
BK
BK
bN
BK
cM
Tf
Hc
"}
(10,1,1) = {"
Tf
Tf
cM
cM
cM
cM
Nj
cM
Ub
ic
BK
Ub
Go
Go
Go
Go
Go
cM
Tf
Tf
"}
(11,1,1) = {"
sM
Tf
cM
cM
cM
cM
cM
cM
Ub
ic
BK
Ub
Go
Vp
Go
Go
Go
cM
Tf
Lh
"}
(12,1,1) = {"
Hc
Tf
cM
BK
xN
BK
BK
BK
Ub
Ub
Ub
Ub
BK
BK
BK
xN
BK
cM
Tf
Hc
"}
(13,1,1) = {"
Hc
Tf
cM
BK
Ub
Ub
Ub
Ub
BK
cM
cM
BK
Ub
Ub
Ub
Ub
BK
cM
Tf
Hc
"}
(14,1,1) = {"
Hc
Tf
cM
BK
ry
tt
cD
Ub
BK
cM
cM
BK
lY
tt
tt
cD
BK
cM
Tf
Hc
"}
(15,1,1) = {"
Hc
Tf
cM
BK
tt
tt
Bw
Ub
BK
cM
cM
BK
Ub
cD
tt
Bw
BK
cM
Tf
Hc
"}
(16,1,1) = {"
Hc
Tf
cM
BK
tt
tt
tt
Ub
bN
cM
cM
bN
Ub
tt
Bw
uH
BK
cM
Tf
Hc
"}
(17,1,1) = {"
Hc
Tf
cM
BK
BK
BK
BK
BK
BK
cM
cM
BK
BK
BK
BK
BK
BK
cM
Tf
Hc
"}
(18,1,1) = {"
Hc
Tf
cM
cM
cM
cM
cM
cM
cM
cM
cM
cM
cM
cM
cM
cM
cM
cM
Tf
Hc
"}
(19,1,1) = {"
Hc
Tf
Tf
Tf
Tf
Tf
Tf
Tf
Tf
Tf
Tf
Tf
Tf
Tf
Tf
Tf
Tf
Tf
Tf
Hc
"}
(20,1,1) = {"
Hc
Hc
Hc
Hc
Hc
Hc
Hc
Hc
Hc
KB
Tf
Hc
Hc
Hc
Hc
Hc
Hc
Hc
Hc
Hc
"}

(1,1,2) = {"
Hc
Hc
Hc
Hc
Hc
Hc
Hc
Hc
eA
eA
eA
eA
Hc
Hc
Hc
Hc
Hc
Hc
Hc
Hc
"}
(2,1,2) = {"
Hc
og
og
og
og
og
og
og
og
og
og
og
og
og
og
og
og
og
og
Hc
"}
(3,1,2) = {"
Hc
og
og
sX
sX
sX
sX
sX
sX
sX
sX
sX
sX
sX
sX
sX
sX
og
og
Hc
"}
(4,1,2) = {"
Hc
og
TJ
Wv
Wv
Wv
Wv
Wv
Wv
Wv
Wv
Wv
Wv
Wv
Wv
Wv
Wv
ze
og
Hc
"}
(5,1,2) = {"
Hc
og
TJ
Wv
nv
ZP
yT
Wv
FY
zB
xd
Xu
Wv
Fu
OT
ZP
Wv
ze
og
Hc
"}
(6,1,2) = {"
Hc
og
TJ
Wv
AO
re
IE
Wv
Ka
zA
Hy
kF
Wv
em
ZP
ZP
Wv
ze
og
Hc
"}
(7,1,2) = {"
Hc
og
TJ
Wv
TR
ZP
IE
Wv
Bk
ZH
GE
ZP
Wv
GY
ZP
ZP
Wv
ze
og
Hc
"}
(8,1,2) = {"
Hc
og
TJ
Wv
ZP
ZP
re
Wv
ZP
ZP
ZP
ZP
Wv
Np
ZP
ZP
Wv
ze
og
Hc
"}
(9,1,2) = {"
eA
og
TJ
Wv
Wv
Wj
Wv
Wv
ZP
ZP
ZP
ZP
Wv
Wv
HN
Wv
Wv
ze
og
eA
"}
(10,1,2) = {"
eA
og
TJ
LS
ZP
ZP
ZP
ZP
ZP
Ht
Tc
ZP
QJ
kM
ZP
ZP
LS
ze
og
eA
"}
(11,1,2) = {"
eA
og
TJ
LS
ZP
ZP
ZP
ZP
ZP
Ht
Tc
ZP
ZP
cp
ZP
ZP
LS
ze
og
eA
"}
(12,1,2) = {"
eA
og
TJ
Wv
Wv
jQ
Wv
Wv
ZP
ZP
ZP
ZP
Wv
Wv
jQ
Wv
Wv
ze
og
eA
"}
(13,1,2) = {"
Hc
og
TJ
Wv
bm
ZP
ZP
Wv
ZP
ZP
ZP
ZP
Wv
QJ
ZP
ZP
Wv
ze
og
Hc
"}
(14,1,2) = {"
Hc
og
TJ
Wv
ZP
ZP
ZP
Wv
vu
ZP
ZP
ZP
Wv
ql
ZP
ZP
Wv
ze
og
Hc
"}
(15,1,2) = {"
Hc
og
TJ
Wv
fU
ZP
ZP
Wv
PH
ZP
ZP
ZP
Wv
zZ
ZP
QJ
Wv
ze
og
Hc
"}
(16,1,2) = {"
Hc
og
TJ
Wv
XO
ZP
mY
Wv
bm
ZP
ZP
ZP
Wv
XO
ZP
ZP
Wv
ze
og
Hc
"}
(17,1,2) = {"
Hc
og
TJ
Wv
Wv
Wv
Wv
Wv
Wv
Wv
Wv
Wv
Wv
Wv
Wv
Wv
Wv
ze
og
Hc
"}
(18,1,2) = {"
Hc
og
og
LR
LR
LR
LR
LR
LR
LR
LR
LR
LR
LR
LR
LR
LR
og
og
Hc
"}
(19,1,2) = {"
Hc
og
og
og
og
og
og
og
og
og
og
og
og
og
og
og
og
og
og
Hc
"}
(20,1,2) = {"
Hc
Hc
Hc
Hc
Hc
Hc
Hc
Hc
eA
eA
eA
eA
Hc
Hc
Hc
Hc
Hc
Hc
Hc
Hc
"}
