//MAP CONVERTED BY dmm2tgm.py THIS HEADER COMMENT PREVENTS RECONVERSION, DO NOT REMOVE
"ac" = (
/mob/living/carbon/human/species/orc/warrior,
/turf/open/floor/hexstone,
/area/rogue/under/tomb/indoors)
"ay" = (
/obj/structure/table/wood/bar,
/turf/open/floor/ruinedwood/darker,
/area/rogue/under/tomb)
"bk" = (
/obj/structure/fluff/railing/border{
	icon_state = "border";
	dir = 1
	},
/turf/open/floor/ruinedwood/darker,
/area/rogue/under/tomb)
"bs" = (
/obj/structure/fluff/walldeco/bsmith,
/turf/open/floor/hexstone,
/area/rogue/under/tomb)
"bz" = (
/turf/closed/wall/mineral/stone/window/moss,
/area/rogue/under/tomb)
"bK" = (
/obj/structure/bed/shit,
/turf/open/floor/hexstone,
/area/rogue/under/tomb/indoors)
"bP" = (
/obj/structure/table/wood/counter{
	dir = 1
	},
/obj/item/reagent_containers/food/snacks/cheese_wedge/aged,
/turf/open/floor/hexstone,
/area/rogue/under/tomb)
"cI" = (
/obj/structure/table/wood/counter{
	dir = 1
	},
/turf/open/floor/hexstone,
/area/rogue/under/tomb)
"cO" = (
/obj/structure/chair/bench/church/smallbench{
	dir = 4
	},
/turf/open/floor/ruinedwood/darker,
/area/rogue/under/tomb)
"dd" = (
/mob/living/carbon/human/species/zizombie/npc/ambush,
/obj/item/natural/poo,
/obj/effect/decal/cleanable/blood/splatter,
/turf/open/floor/hexstone,
/area/rogue/under/tomb/indoors)
"dC" = (
/obj/structure/fluff/railing/border{
	icon_state = "border";
	dir = 1
	},
/obj/structure/chair/bench/church/mid,
/mob/living/carbon/human/species/skeleton/npc/no_equipment,
/turf/open/floor/ruinedwood/darker,
/area/rogue/under/tomb)
"ei" = (
/turf/closed/mineral/bedrock,
/area/rogue/under/tomb)
"eH" = (
/obj/effect/dungeon_directional_helper/south,
/turf/open/floor/hexstone,
/area/rogue/under/tomb)
"eI" = (
/obj/structure/rack/shelf/big,
/turf/open/floor/hexstone,
/area/rogue/under/tomb)
"eN" = (
/obj/structure/table/wood/counter{
	dir = 1
	},
/obj/item/reagent_containers/food/snacks/cooked/sausage{
	pixel_x = 12;
	pixel_y = 11
	},
/turf/open/floor/hexstone,
/area/rogue/under/tomb)
"ge" = (
/obj/structure/fluff/railing/border{
	icon_state = "border";
	dir = 1
	},
/obj/structure/chair/bench/church/mid,
/obj/item/clothing/head/peaceflower,
/mob/living/carbon/human/species/skeleton/npc/no_equipment,
/obj/effect/mapping_helpers/floor_clothing_equipper,
/turf/open/floor/ruinedwood/darker,
/area/rogue/under/tomb)
"gg" = (
/obj/machinery/light/fueled/torchholder/r,
/turf/open/floor/hexstone,
/area/rogue/under/tomb/indoors)
"iU" = (
/obj/item/clothing/shoes/boots/armor,
/obj/structure/fluff/walldeco/chains,
/turf/open/floor/hexstone,
/area/rogue/under/tomb/indoors)
"kl" = (
/obj/structure/chair/bench/church/mid,
/mob/living/carbon/human/species/skeleton/npc/no_equipment,
/turf/open/floor/ruinedwood/darker,
/area/rogue/under/tomb)
"kw" = (
/obj/effect/decal/cleanable/blood/footprints,
/turf/open/floor/hexstone,
/area/rogue/under/tomb/indoors)
"kE" = (
/mob/living/carbon/human/species/skeleton/npc/warrior,
/turf/open/floor/ruinedwood/darker,
/area/rogue/under/tomb)
"lC" = (
/obj/structure/stairs/stone,
/turf/open/floor/hexstone,
/area/rogue/under/tomb)
"nb" = (
/turf/open/floor/hexstone,
/area/rogue/under/tomb)
"nS" = (
/turf/open/floor/ruinedwood/darker,
/area/rogue/under/tomb)
"om" = (
/obj/structure/fluff/railing/border{
	icon_state = "border";
	dir = 8
	},
/turf/open/floor/ruinedwood/darker,
/area/rogue/under/tomb)
"oE" = (
/obj/effect/decal/cleanable/blood/tracks,
/turf/open/floor/hexstone,
/area/rogue/under/tomb/indoors)
"oT" = (
/obj/item/natural/stone{
	pixel_y = 5
	},
/mob/living/carbon/human/species/orc/ambush{
	name = "Slambo"
	},
/turf/open/floor/hexstone,
/area/rogue/under/tomb)
"px" = (
/obj/effect/decal/cleanable/blood/gibs,
/turf/open/floor/hexstone,
/area/rogue/under/tomb/indoors)
"qc" = (
/obj/structure/chair/bench/church/mid,
/turf/open/floor/ruinedwood/darker,
/area/rogue/under/tomb)
"qg" = (
/obj/item/weapon/polearm/spear,
/obj/effect/decal/cleanable/blood,
/turf/open/floor/hexstone,
/area/rogue/under/tomb/indoors)
"rl" = (
/mob/living/carbon/human/species/skeleton/npc/warrior,
/turf/open/floor/hexstone,
/area/rogue/under/tomb/indoors)
"ry" = (
/obj/item/clothing/gloves/chain/iron,
/turf/open/floor/hexstone,
/area/rogue/under/tomb/indoors)
"sB" = (
/obj/structure/grindwheel,
/turf/open/floor/hexstone,
/area/rogue/under/tomb)
"tp" = (
/obj/structure/chair/bench/church/smallbench{
	dir = 4
	},
/obj/structure/fluff/railing/border,
/turf/open/floor/ruinedwood/darker,
/area/rogue/under/tomb)
"ts" = (
/mob/living/carbon/human/species/goblin/npc/hell{
	name = "Weinerman"
	},
/turf/open/floor/hexstone,
/area/rogue/under/tomb)
"ty" = (
/obj/structure/table/wood/counter/end{
	dir = 1
	},
/turf/open/floor/hexstone,
/area/rogue/under/tomb)
"uM" = (
/turf/open/floor/ruinedwood/darker,
/area/rogue/under/tomb/indoors)
"vp" = (
/obj/structure/stairs/stone{
	dir = 1
	},
/turf/open/floor/ruinedwood/darker,
/area/rogue/under/tomb)
"vI" = (
/obj/structure/chair/bench/church{
	dir = 1
	},
/turf/open/floor/ruinedwood/darker,
/area/rogue/under/tomb)
"wW" = (
/obj/structure/door,
/obj/effect/mapping_helpers/door/locker,
/turf/open/floor/hexstone,
/area/rogue/under/tomb/indoors)
"xE" = (
/obj/structure/chair/bench/couchablack,
/mob/living/carbon/human/species/skeleton/npc/ambush,
/turf/open/floor/ruinedwood/darker,
/area/rogue/under/tomb/indoors)
"yw" = (
/obj/effect/decal/cleanable/blood/gibs/up,
/turf/open/floor/hexstone,
/area/rogue/under/tomb/indoors)
"zi" = (
/obj/machinery/light/fueled/torchholder/l,
/mob/living/carbon/human/species/skeleton/npc/warrior,
/turf/open/floor/hexstone,
/area/rogue/under/tomb/indoors)
"zp" = (
/obj/structure/rack/shelf/big,
/obj/item/reagent_containers/glass/cup/silver{
	pixel_x = 6;
	pixel_y = 19
	},
/obj/item/reagent_containers/glass/cup/silver{
	pixel_y = 21;
	pixel_x = -6
	},
/turf/open/floor/ruinedwood/darker,
/area/rogue/under/tomb)
"zt" = (
/obj/structure/door/viewport{
	dir = 4
	},
/obj/effect/mapping_helpers/door/locker,
/turf/open/floor/hexstone,
/area/rogue/under/tomb/indoors)
"zv" = (
/obj/structure/rack/shelf/biggest,
/obj/item/reagent_containers/glass/bottle/strongpoison,
/turf/open/floor/ruinedwood/darker,
/area/rogue/under/tomb/indoors)
"zx" = (
/obj/structure/fluff/railing/border{
	icon_state = "border";
	dir = 1
	},
/obj/structure/chair/bench/church/r,
/turf/open/floor/ruinedwood/darker,
/area/rogue/under/tomb)
"zI" = (
/obj/structure/chair/bench/church/mid,
/mob/living/carbon/human/species/skeleton/npc/peasant,
/turf/open/floor/ruinedwood/darker,
/area/rogue/under/tomb)
"At" = (
/obj/structure/door/viewport{
	dir = 8
	},
/obj/effect/mapping_helpers/door/locker,
/turf/open/floor/hexstone,
/area/rogue/under/tomb/indoors)
"Ay" = (
/obj/structure/fluff/railing/border,
/turf/open/floor/ruinedwood/darker,
/area/rogue/under/tomb/indoors)
"AZ" = (
/obj/structure/stairs/stone,
/turf/open/floor/ruinedwood/darker,
/area/rogue/under/tomb)
"Br" = (
/obj/structure/table/wood/counter/end,
/obj/item/reagent_containers/food/snacks/cooked/sausage,
/turf/open/floor/hexstone,
/area/rogue/under/tomb)
"BK" = (
/obj/effect/decal/cleanable/blood/gibs/limb,
/turf/open/floor/hexstone,
/area/rogue/under/tomb/indoors)
"BY" = (
/turf/closed/wall/mineral/stone/window/moss,
/area/rogue/under/tomb/indoors)
"Cg" = (
/obj/structure/rack/shelf/biggest,
/obj/item/weapon/polearm/spear/billhook,
/obj/item/weapon/polearm/spear/billhook{
	pixel_y = -8
	},
/turf/open/floor/hexstone,
/area/rogue/under/tomb)
"Cl" = (
/obj/structure/door/viewport{
	dir = 8
	},
/obj/effect/mapping_helpers/door/locker,
/turf/open/floor/ruinedwood/darker,
/area/rogue/under/tomb/indoors)
"Dg" = (
/obj/item/weapon/sword/arming,
/turf/open/floor/hexstone,
/area/rogue/under/tomb/indoors)
"Eu" = (
/obj/machinery/light/fueled/forge,
/obj/item/weapon/tongs,
/turf/open/floor/hexstone,
/area/rogue/under/tomb)
"FO" = (
/obj/structure/fluff/railing/border{
	icon_state = "border";
	dir = 6
	},
/turf/open/floor/ruinedwood/darker,
/area/rogue/under/tomb)
"FQ" = (
/obj/structure/chair/bench/church/smallbench{
	dir = 4
	},
/obj/structure/fluff/railing/border{
	dir = 10;
	icon_state = "border"
	},
/mob/living/carbon/human/species/skeleton/npc/no_equipment,
/turf/open/floor/ruinedwood/darker,
/area/rogue/under/tomb)
"Gc" = (
/mob/living/carbon/human/species/goblin/npc/hell{
	name = "Bobby Baker"
	},
/turf/open/floor/hexstone,
/area/rogue/under/tomb)
"Gh" = (
/obj/item/ore/coal,
/turf/open/floor/hexstone,
/area/rogue/under/tomb)
"Go" = (
/turf/closed/wall/mineral/stonebrick,
/area/rogue/under/tomb/indoors)
"GN" = (
/obj/machinery/light/fueled/torchholder/l,
/turf/open/floor/hexstone,
/area/rogue/under/tomb/indoors)
"GU" = (
/obj/structure/door/viewport{
	dir = 4
	},
/obj/effect/mapping_helpers/door/locker,
/turf/open/floor/ruinedwood/darker,
/area/rogue/under/tomb)
"HM" = (
/obj/structure/chair/bench/church/smallbench{
	dir = 4
	},
/obj/item/clothing/head/peaceflower,
/mob/living/carbon/human/species/skeleton/npc/no_equipment,
/obj/effect/mapping_helpers/floor_clothing_equipper,
/turf/open/floor/ruinedwood/darker,
/area/rogue/under/tomb)
"HS" = (
/turf/open/transparent/openspace,
/area/rogue/under/tomb)
"IL" = (
/obj/item/natural/stone,
/obj/item/natural/stone,
/obj/item/natural/stone,
/obj/item/natural/stone{
	pixel_y = 10;
	pixel_x = 10
	},
/obj/machinery/anvil,
/obj/item/weapon/hammer/iron,
/turf/open/floor/hexstone,
/area/rogue/under/tomb)
"IM" = (
/obj/structure/bars,
/turf/open/floor/hexstone,
/area/rogue/under/tomb/indoors)
"IX" = (
/obj/structure/fluff/walldeco/stone,
/turf/closed/wall/mineral/stone/window/moss,
/area/rogue/under/tomb)
"JQ" = (
/obj/structure/table/wood/counter{
	dir = 1
	},
/obj/item/reagent_containers/food/snacks/cooked/sausage,
/turf/open/floor/hexstone,
/area/rogue/under/tomb)
"JS" = (
/mob/living/carbon/human/species/goblin/npc/ambush/sea,
/turf/open/floor/hexstone,
/area/rogue/under/tomb/indoors)
"KY" = (
/obj/item/restraints/legcuffs/beartrap/armed/camouflage,
/turf/open/floor/hexstone,
/area/rogue/under/tomb)
"Lc" = (
/obj/effect/decal/cleanable/blood/splatter,
/turf/open/floor/hexstone,
/area/rogue/under/tomb/indoors)
"LE" = (
/obj/effect/dungeon_directional_helper/west,
/turf/open/floor/hexstone,
/area/rogue/under/tomb)
"LR" = (
/obj/structure/table/wood/bar,
/obj/structure/fluff/railing/border{
	icon_state = "border";
	dir = 5
	},
/turf/open/floor/ruinedwood/darker,
/area/rogue/under/tomb)
"MH" = (
/turf/closed/wall/mineral/stonebrick,
/area/rogue/under/tomb)
"Np" = (
/obj/structure/table/wood/counter{
	dir = 1
	},
/obj/item/reagent_containers/food/snacks/cooked/sausage{
	pixel_y = 5;
	pixel_x = -7
	},
/turf/open/floor/hexstone,
/area/rogue/under/tomb)
"NH" = (
/obj/structure/window/stained/silver,
/turf/open/floor/ruinedwood/darker,
/area/rogue/under/tomb/indoors)
"NI" = (
/obj/structure/fluff/railing/border,
/obj/structure/table/vtable/v2,
/obj/item/reagent_containers/glass/cup/golden{
	pixel_y = 8;
	pixel_x = 8
	},
/obj/item/weapon/sword/decorated{
	pixel_x = -5;
	pixel_y = 8
	},
/obj/item/gem,
/obj/item/gem{
	pixel_x = -11;
	pixel_y = 11
	},
/turf/open/floor/ruinedwood/darker,
/area/rogue/under/tomb/indoors)
"Of" = (
/obj/structure/fluff/railing/border{
	dir = 10;
	icon_state = "border"
	},
/turf/open/floor/ruinedwood/darker,
/area/rogue/under/tomb)
"Oj" = (
/obj/structure/chair/bench/church/r,
/turf/open/floor/ruinedwood/darker,
/area/rogue/under/tomb)
"OF" = (
/obj/structure/fluff/railing/border{
	icon_state = "border";
	dir = 5
	},
/turf/open/floor/ruinedwood/darker,
/area/rogue/under/tomb)
"OQ" = (
/obj/structure/rack/shelf/biggest,
/obj/item/gun/ballistic/revolver/grenadelauncher/bow/long,
/obj/item/ammo_holder/quiver/arrows,
/turf/open/floor/ruinedwood/darker,
/area/rogue/under/tomb/indoors)
"OS" = (
/obj/item/ingot/iron,
/obj/item/ingot/iron{
	pixel_y = -2;
	pixel_x = 12
	},
/obj/item/ingot/iron{
	pixel_y = 5;
	pixel_x = 7
	},
/turf/open/floor/hexstone,
/area/rogue/under/tomb)
"QU" = (
/obj/structure/chair/bench/church/smallbench{
	dir = 4
	},
/mob/living/carbon/human/species/skeleton/npc/no_equipment,
/turf/open/floor/ruinedwood/darker,
/area/rogue/under/tomb)
"Rc" = (
/obj/structure/fluff/railing/border{
	icon_state = "border";
	dir = 1
	},
/obj/structure/chair/bench/church{
	dir = 1
	},
/turf/open/floor/ruinedwood/darker,
/area/rogue/under/tomb)
"RF" = (
/obj/structure/fluff/railing/border{
	icon_state = "border";
	dir = 4
	},
/turf/open/floor/ruinedwood/darker,
/area/rogue/under/tomb)
"RP" = (
/obj/structure/chair/bench/church/smallbench{
	dir = 4
	},
/mob/living/carbon/human/species/skeleton/npc/peasant,
/turf/open/floor/ruinedwood/darker,
/area/rogue/under/tomb)
"Sj" = (
/obj/item/weapon/knife/dagger/steel,
/turf/open/floor/hexstone,
/area/rogue/under/tomb/indoors)
"Sw" = (
/obj/structure/stairs/stone{
	dir = 1
	},
/turf/open/floor/hexstone,
/area/rogue/under/tomb)
"Ud" = (
/turf/open/floor/rooftop{
	dir = 1
	},
/area/rogue/under/tomb)
"VA" = (
/obj/structure/chair/bench/couchablack/r,
/mob/living/carbon/human/species/skeleton/npc/warrior/skilled{
	name = "Lord of the Pit"
	},
/turf/open/floor/ruinedwood/darker,
/area/rogue/under/tomb/indoors)
"VI" = (
/turf/open/floor/hexstone,
/area/rogue/under/tomb/indoors)
"VX" = (
/obj/structure/fluff/railing/border,
/obj/structure/table/vtable,
/obj/item/reagent_containers/glass/cup/golden{
	pixel_y = 8;
	pixel_x = -5
	},
/obj/item/reagent_containers/glass/bottle/redwine{
	pixel_y = 12;
	pixel_x = 7
	},
/turf/open/floor/ruinedwood/darker,
/area/rogue/under/tomb/indoors)
"Wc" = (
/obj/effect/decal/cleanable/blood/gibs/core,
/turf/open/floor/hexstone,
/area/rogue/under/tomb/indoors)
"Xd" = (
/obj/structure/fermentation_keg/random/beer,
/turf/open/floor/ruinedwood/darker,
/area/rogue/under/tomb)
"Xs" = (
/obj/structure/fluff/railing/border{
	dir = 9;
	icon_state = "border"
	},
/turf/open/floor/ruinedwood/darker,
/area/rogue/under/tomb)
"Xy" = (
/obj/structure/table/wood/counter{
	dir = 1
	},
/obj/item/reagent_containers/food/snacks/biscuit_poison,
/obj/item/reagent_containers/food/snacks/biscuit,
/obj/item/reagent_containers/food/snacks/biscuit{
	pixel_x = 12
	},
/obj/item/reagent_containers/food/snacks/biscuit{
	pixel_y = 5;
	pixel_x = 8
	},
/obj/item/reagent_containers/food/snacks/biscuit{
	pixel_y = 12;
	pixel_x = 9
	},
/turf/open/floor/hexstone,
/area/rogue/under/tomb)
"XN" = (
/obj/structure/fermentation_keg/random/water,
/turf/open/floor/ruinedwood/darker,
/area/rogue/under/tomb)
"Yk" = (
/mob/living/carbon/human/species/skeleton/npc/peasant,
/turf/open/floor/ruinedwood/darker,
/area/rogue/under/tomb)
"YE" = (
/obj/structure/table/wood/bar,
/obj/item/reagent_containers/glass/cup/skull,
/turf/open/floor/ruinedwood/darker,
/area/rogue/under/tomb)
"YV" = (
/obj/item/clothing/armor/chainmail/iron,
/turf/open/floor/hexstone,
/area/rogue/under/tomb/indoors)

(1,1,1) = {"
ei
ei
ei
ei
ei
ei
ei
nb
nb
LE
nb
nb
ei
ei
ei
ei
ei
ei
ei
ei
"}
(2,1,1) = {"
ei
nb
nb
nb
nb
nb
nb
nb
nb
nb
nb
nb
nb
nb
nb
nb
nb
nb
nb
ei
"}
(3,1,1) = {"
ei
nb
bs
nb
nb
OS
bz
nb
nb
nb
bz
bz
bz
bz
nb
nb
nb
Br
nb
ei
"}
(4,1,1) = {"
ei
nb
nb
IL
oT
Cg
bz
nb
nb
nb
nb
nb
lC
bz
nb
nb
nb
Xy
nb
ei
"}
(5,1,1) = {"
ei
nb
nb
nb
sB
bz
IX
nb
KY
nb
nb
nb
lC
bz
bz
nb
nb
cI
nb
ei
"}
(6,1,1) = {"
ei
nb
Gh
Eu
bz
bz
nb
nb
nb
nb
nb
nb
nb
nb
bz
bz
Gc
bP
nb
ei
"}
(7,1,1) = {"
ei
nb
bz
bz
bz
nb
nb
nb
Go
Go
zt
Go
nb
nb
nb
bz
bz
bz
nb
ei
"}
(8,1,1) = {"
ei
nb
nb
nb
nb
nb
nb
Go
VI
JS
oE
YV
Go
nb
nb
nb
nb
bz
nb
ei
"}
(9,1,1) = {"
ei
nb
nb
nb
nb
nb
Go
zi
px
qg
BK
kw
GN
Go
nb
nb
nb
nb
nb
nb
"}
(10,1,1) = {"
ei
nb
nb
nb
nb
nb
IM
iU
VI
Sj
VI
ac
VI
IM
nb
nb
nb
nb
nb
nb
"}
(11,1,1) = {"
ei
nb
nb
nb
KY
nb
IM
dd
yw
Wc
ry
ac
VI
IM
nb
nb
nb
nb
nb
eH
"}
(12,1,1) = {"
ei
nb
nb
nb
nb
nb
Go
gg
rl
VI
Dg
VI
gg
Go
nb
KY
nb
nb
nb
nb
"}
(13,1,1) = {"
ei
nb
nb
nb
nb
nb
nb
Go
VI
VI
VI
Lc
Go
nb
nb
nb
nb
bz
nb
ei
"}
(14,1,1) = {"
ei
nb
BY
wW
BY
nb
nb
nb
Go
At
Go
Go
nb
nb
nb
bz
bz
bz
nb
ei
"}
(15,1,1) = {"
ei
nb
BY
VI
BY
BY
nb
nb
nb
nb
nb
nb
nb
nb
bz
bz
nb
eN
nb
ei
"}
(16,1,1) = {"
ei
nb
BY
VI
bK
BY
BY
Sw
nb
nb
nb
KY
nb
bz
bz
eI
ts
JQ
nb
ei
"}
(17,1,1) = {"
ei
nb
BY
VI
VI
bK
BY
Sw
nb
nb
nb
nb
nb
bz
nb
nb
nb
Np
nb
ei
"}
(18,1,1) = {"
ei
nb
BY
BY
BY
BY
BY
bz
bz
nb
nb
nb
bz
bz
nb
nb
nb
ty
nb
ei
"}
(19,1,1) = {"
ei
nb
nb
nb
nb
nb
nb
nb
nb
nb
nb
nb
nb
nb
nb
nb
nb
nb
nb
ei
"}
(20,1,1) = {"
ei
ei
ei
ei
ei
ei
ei
ei
ei
ei
ei
ei
ei
ei
ei
ei
ei
ei
ei
ei
"}

(1,1,2) = {"
ei
ei
ei
ei
ei
ei
ei
MH
nS
nS
nS
MH
ei
ei
ei
ei
ei
ei
ei
ei
"}
(2,1,2) = {"
ei
HS
HS
HS
HS
HS
HS
MH
nS
nS
nS
MH
HS
HS
HS
HS
HS
HS
HS
ei
"}
(3,1,2) = {"
ei
HS
HS
HS
HS
HS
MH
MH
nS
nS
nS
MH
MH
MH
MH
HS
HS
HS
HS
ei
"}
(4,1,2) = {"
ei
HS
HS
HS
HS
HS
MH
nS
cO
cO
cO
tp
HS
AZ
MH
HS
HS
HS
HS
ei
"}
(5,1,2) = {"
ei
HS
HS
HS
HS
MH
MH
nS
RP
QU
cO
tp
HS
AZ
MH
HS
HS
HS
HS
ei
"}
(6,1,2) = {"
ei
HS
HS
HS
MH
MH
nS
nS
HM
cO
cO
FQ
om
nS
MH
MH
HS
HS
HS
ei
"}
(7,1,2) = {"
ei
HS
Go
Go
Go
kE
nS
FO
RF
RF
RF
RF
OF
nS
nS
MH
MH
MH
HS
ei
"}
(8,1,2) = {"
ei
HS
Go
zv
Go
GU
MH
MH
HS
HS
HS
HS
MH
OF
nS
nS
nS
MH
MH
MH
"}
(9,1,2) = {"
ei
HS
NH
uM
uM
uM
Ay
HS
HS
HS
HS
HS
HS
Rc
vI
vI
nS
nS
nS
nS
"}
(10,1,2) = {"
ei
HS
Go
uM
uM
xE
VX
HS
HS
HS
HS
HS
HS
dC
qc
qc
nS
nS
nS
nS
"}
(11,1,2) = {"
ei
HS
Go
uM
uM
VA
NI
HS
HS
HS
HS
HS
HS
ge
kl
zI
nS
nS
nS
nS
"}
(12,1,2) = {"
ei
HS
NH
uM
uM
uM
Ay
HS
HS
HS
HS
HS
HS
zx
Oj
Oj
nS
nS
nS
nS
"}
(13,1,2) = {"
ei
HS
Go
OQ
Go
Cl
Go
MH
HS
HS
HS
HS
MH
nS
nS
nS
nS
MH
MH
MH
"}
(14,1,2) = {"
ei
HS
Go
Go
Go
kE
nS
Of
om
om
om
om
Xs
nS
nS
MH
MH
MH
HS
ei
"}
(15,1,2) = {"
ei
HS
Ud
Ud
MH
MH
nS
RF
LR
YE
ay
YE
nS
nS
MH
MH
HS
HS
HS
ei
"}
(16,1,2) = {"
ei
HS
Ud
Ud
Ud
MH
vp
HS
bk
nS
nS
nS
nS
MH
MH
HS
HS
HS
HS
ei
"}
(17,1,2) = {"
ei
HS
Ud
Ud
Ud
MH
vp
HS
bk
zp
Yk
XN
Xd
MH
HS
HS
HS
HS
HS
ei
"}
(18,1,2) = {"
ei
HS
Ud
Ud
Ud
MH
MH
MH
MH
MH
MH
MH
MH
MH
HS
HS
HS
HS
HS
ei
"}
(19,1,2) = {"
ei
HS
HS
HS
HS
HS
HS
HS
HS
HS
HS
HS
HS
HS
HS
HS
HS
HS
HS
ei
"}
(20,1,2) = {"
ei
ei
ei
ei
ei
ei
ei
ei
ei
ei
ei
ei
ei
ei
ei
ei
ei
ei
ei
ei
"}
