//MAP CONVERTED BY dmm2tgm.py THIS HEADER COMMENT PREVENTS RECONVERSION, DO NOT REMOVE
"bD" = (
/obj/effect/decal/cobbleedge{
	dir = 10
	},
/turf/open/floor/naturalstone,
/area/rogue/under/tomb)
"bT" = (
/obj/effect/dungeon_directional_helper/east,
/turf/open/floor/naturalstone,
/area/rogue/under/tomb)
"ci" = (
/obj/machinery/light/fueled/torchholder/l,
/obj/effect/decal/cleanable/dirt/dust,
/obj/effect/decal/cleanable/dirt/dust,
/turf/open/floor/blocks,
/area/rogue/under/tomb/indoors/rest)
"cy" = (
/obj/machinery/light/fueled/torchholder/l,
/obj/effect/decal/cleanable/dirt/dust,
/turf/open/floor/blocks,
/area/rogue/under/tomb/indoors/rest)
"cO" = (
/turf/open/floor/naturalstone,
/area/rogue/under/tomb)
"dH" = (
/obj/item/candle/yellow,
/obj/structure/table/wood/plain/alt,
/turf/open/floor/wood,
/area/rogue/under/tomb/indoors/rest)
"eA" = (
/obj/structure/table/wood/treestump/shroomstump,
/turf/open/floor/dirt/road,
/area/rogue/under/tomb)
"go" = (
/turf/open/floor/carpet/purple,
/area/rogue/under/tomb/indoors/rest)
"hd" = (
/obj/structure/closet/crate/chest/neu,
/obj/effect/spawner/map_spawner/loot/potion_ingredient/herb,
/obj/effect/spawner/map_spawner/loot/potion_ingredient/herb,
/obj/effect/spawner/map_spawner/loot/potion_ingredient/herb,
/obj/effect/spawner/map_spawner/loot/potion_ingredient/herb,
/obj/effect/spawner/map_spawner/loot/potion_ingredient/herb,
/obj/effect/decal/cleanable/dirt/dust,
/turf/open/floor/blocks,
/area/rogue/under/tomb/indoors/rest)
"hO" = (
/obj/machinery/light/fueled/wallfire/candle/weak/l,
/obj/structure/mannequin/male/female,
/turf/open/floor/herringbone,
/area/rogue/under/tomb/indoors)
"iO" = (
/turf/open/water/swamp,
/area/rogue/under/tomb)
"iU" = (
/obj/structure/table/wood/treestump/shroomstump,
/turf/open/floor/dirt,
/area/rogue/under/tomb)
"iV" = (
/obj/effect/decal/shadow_floor{
	dir = 5
	},
/obj/effect/decal/cleanable/dirt/dust,
/turf/open/floor/cobble,
/area/rogue/under/tomb/indoors/rest)
"jy" = (
/mob/living/simple_animal/hostile/retaliate/trufflepig,
/obj/item/clothing/shirt/undershirt/fancy{
	pixel_x = 10;
	pixel_y = 6
	},
/turf/open/floor/carpet/royalblack,
/area/rogue/under/tomb/indoors/rest)
"kt" = (
/obj/effect/decal/shadow_floor,
/obj/effect/decal/cleanable/dirt/dust,
/turf/open/floor/blocks,
/area/rogue/under/tomb/indoors/rest)
"kS" = (
/turf/open/floor/dirt,
/area/rogue/under/tomb)
"lm" = (
/obj/effect/decal/cobbleedge{
	dir = 9
	},
/turf/open/floor/naturalstone,
/area/rogue/under/tomb)
"ma" = (
/turf/open/floor/dirt/road,
/area/rogue/under/tomb)
"nq" = (
/turf/open/floor/cobble,
/area/rogue/under/tomb/indoors/rest)
"nJ" = (
/obj/structure/trap/bomb,
/turf/open/floor/carpet/red,
/area/rogue/under/tomb/indoors)
"nY" = (
/obj/effect/decal/cobbleedge,
/turf/open/floor/naturalstone,
/area/rogue/under/tomb)
"oL" = (
/obj/machinery/light/fueled/wallfire/candle/weak/l,
/turf/open/floor/herringbone,
/area/rogue/under/tomb/indoors)
"pG" = (
/turf/closed/wall/mineral/decostone/center,
/area/rogue/under/tomb/indoors)
"pS" = (
/obj/effect/decal/cleanable/dirt/dust,
/turf/open/floor/blocks/green,
/area/rogue/under/tomb/indoors/rest)
"qb" = (
/turf/closed/wall/mineral/stone,
/area/rogue/under/tomb)
"qJ" = (
/obj/structure/door/weak/bolt{
	dir = 1
	},
/obj/effect/mapping_helpers/door/locker,
/obj/effect/decal/shadow_floor,
/turf/open/floor/blocks,
/area/rogue/under/tomb/indoors/rest)
"ra" = (
/obj/structure/table/wood/nice/decorated,
/obj/item/reagent_containers/glass/carafe/silver/redwine{
	pixel_y = 11;
	pixel_x = -2
	},
/turf/open/floor/wood,
/area/rogue/under/tomb/indoors/rest)
"sq" = (
/obj/effect/decal/cleanable/dirt/dust,
/turf/open/floor/blocks,
/area/rogue/under/tomb/indoors/rest)
"sE" = (
/obj/effect/decal/cobbleedge{
	dir = 1
	},
/turf/open/floor/naturalstone,
/area/rogue/under/tomb)
"te" = (
/obj/structure/closet/crate/crafted_closet/dark,
/obj/item/clothing/ring/silver,
/turf/open/floor/carpet/royalblack,
/area/rogue/under/tomb/indoors/rest)
"tt" = (
/obj/effect/decal/cleanable/dirt/dust,
/turf/open/floor/wood,
/area/rogue/under/tomb/indoors/rest)
"tC" = (
/obj/item/clothing/pants/skirt/random{
	pixel_x = 8;
	pixel_y = 9
	},
/obj/effect/decal/cleanable/vomit/old,
/turf/open/floor/carpet/royalblack,
/area/rogue/under/tomb/indoors/rest)
"ux" = (
/obj/structure/door/stone,
/turf/open/floor/herringbone,
/area/rogue/under/tomb/indoors)
"vC" = (
/obj/structure/door/weak/bolt{
	dir = 1
	},
/turf/open/floor/blocks,
/area/rogue/under/tomb/indoors/rest)
"wk" = (
/obj/machinery/light/fueled/lanternpost{
	dir = 1
	},
/turf/open/floor/cobble,
/area/rogue/under/tomb)
"wu" = (
/obj/structure/stairs/stone,
/turf/open/floor/cobble,
/area/rogue/under/tomb/indoors/rest)
"wO" = (
/obj/structure/roguerock,
/turf/open/floor/naturalstone,
/area/rogue/under/tomb)
"xA" = (
/obj/item/clothing/gloves/leather{
	pixel_x = -7;
	pixel_y = -9
	},
/obj/effect/decal/cleanable/vomit/old,
/turf/open/floor/carpet/royalblack,
/area/rogue/under/tomb/indoors/rest)
"xJ" = (
/obj/structure/fluff/railing/wood{
	dir = 4
	},
/turf/open/floor/wood,
/area/rogue/under/tomb/indoors/rest)
"yx" = (
/obj/structure/fluff/walldeco/painting/skull{
	pixel_x = -32
	},
/obj/effect/decal/cleanable/dirt/dust,
/turf/open/floor/wood,
/area/rogue/under/tomb/indoors/rest)
"yV" = (
/obj/structure/door/red,
/turf/open/floor/wood/nosmooth,
/area/rogue/under/tomb/indoors/rest)
"zf" = (
/turf/open/floor/blocks,
/area/rogue/under/tomb/indoors/rest)
"zu" = (
/obj/machinery/light/fueled/torchholder/l,
/obj/effect/decal/cleanable/dirt/dust,
/turf/open/floor/cobble,
/area/rogue/under/tomb/indoors/rest)
"zx" = (
/obj/structure/table/wood/reinforced_alter,
/obj/structure/bars/bent,
/obj/effect/decal/shadow_floor,
/turf/open/floor/blocks,
/area/rogue/under/tomb/indoors/rest)
"zN" = (
/obj/structure/stairs/stone,
/obj/machinery/light/fueled/wallfire/candle/r,
/turf/open/floor/cobble,
/area/rogue/under/tomb/indoors/rest)
"zS" = (
/obj/structure/table/stone_small,
/obj/item/reagent_containers/glass/mortar{
	pixel_y = 9
	},
/turf/open/floor/cobble,
/area/rogue/under/tomb/indoors/rest)
"zV" = (
/obj/effect/dungeon_directional_helper/north,
/turf/open/floor/dirt/road,
/area/rogue/under/tomb)
"AO" = (
/turf/open/floor/carpet/red,
/area/rogue/under/tomb/indoors)
"Cb" = (
/obj/structure/fluff/railing/wood{
	dir = 4
	},
/obj/effect/decal/cleanable/dirt/dust,
/turf/open/floor/wood,
/area/rogue/under/tomb/indoors/rest)
"Ch" = (
/obj/machinery/light/fueled/torchholder/r,
/turf/open/floor/cobble,
/area/rogue/under/tomb/indoors/rest)
"Cq" = (
/turf/open/floor/wood,
/area/rogue/under/tomb/indoors/rest)
"DV" = (
/obj/structure/flora/grass/herb/random,
/turf/open/floor/dirt,
/area/rogue/under/tomb)
"DY" = (
/obj/item/clothing/neck/psycross/g{
	pixel_x = -6;
	pixel_y = 0
	},
/obj/structure/table/stone_small,
/obj/item/weapon/knife/dagger/silver{
	pixel_x = 6;
	pixel_y = 5
	},
/turf/open/floor/carpet/red,
/area/rogue/under/tomb/indoors)
"EG" = (
/obj/machinery/light/fueled/wallfire/candle/r,
/obj/structure/bed/inn,
/obj/item/bedsheet/wool,
/turf/open/floor/carpet/royalblack,
/area/rogue/under/tomb/indoors/rest)
"Fu" = (
/obj/effect/decal/cobbleedge{
	dir = 8
	},
/turf/open/floor/naturalstone,
/area/rogue/under/tomb)
"Fv" = (
/turf/closed/wall/mineral/stone,
/area/rogue/under/tomb/indoors/rest)
"FO" = (
/obj/structure/door/red,
/turf/open/floor/blocks,
/area/rogue/under/tomb/indoors/rest)
"FS" = (
/obj/effect/decal/cobbleedge{
	dir = 6
	},
/turf/open/floor/naturalstone,
/area/rogue/under/tomb)
"Gi" = (
/obj/structure/fluff/railing/wood,
/turf/open/floor/wood,
/area/rogue/under/tomb/indoors/rest)
"HY" = (
/turf/open/floor/cobblerock,
/area/rogue/under/tomb)
"Jr" = (
/obj/structure/fermentation_keg/random/water,
/turf/open/floor/blocks,
/area/rogue/under/tomb/indoors/rest)
"JP" = (
/obj/structure/mannequin,
/turf/open/floor/herringbone,
/area/rogue/under/tomb/indoors)
"Kv" = (
/turf/open/floor/blocks/green,
/area/rogue/under/tomb/indoors/rest)
"KJ" = (
/obj/structure/stairs/stone{
	dir = 1;
	icon_state = "stonestairs"
	},
/obj/structure/fluff/railing/wood{
	dir = 4;
	pixel_y = 8
	},
/turf/open/floor/cobble,
/area/rogue/under/tomb/indoors/rest)
"LQ" = (
/turf/open/transparent/openspace,
/area/rogue/under/tomb)
"MR" = (
/obj/structure/closet/crate/chest/neu,
/obj/item/alch/firedust,
/obj/item/alch/magicdust,
/obj/item/alch/earthdust,
/obj/item/alch/coaldust,
/obj/item/alch/coaldust,
/obj/effect/decal/cleanable/dirt/dust,
/turf/open/floor/blocks,
/area/rogue/under/tomb/indoors/rest)
"MY" = (
/obj/structure/mannequin/male,
/turf/open/floor/herringbone,
/area/rogue/under/tomb/indoors)
"NS" = (
/obj/structure/table/stone_small,
/obj/item/reagent_containers/food/snacks/meat/fatty{
	pixel_x = -5;
	pixel_y = 3
	},
/obj/item/reagent_containers/food/snacks/fat{
	pixel_y = 13
	},
/obj/item/reagent_containers/food/snacks/truffles{
	pixel_x = -5;
	pixel_y = 5
	},
/turf/open/floor/cobble,
/area/rogue/under/tomb/indoors/rest)
"Oa" = (
/obj/effect/decal/remains/human,
/obj/item/reagent_containers/glass/bottle{
	pixel_x = -6;
	pixel_y = -6;
	closed = 0
	},
/turf/open/floor/carpet/royalblack,
/area/rogue/under/tomb/indoors/rest)
"Ob" = (
/obj/structure/trap/wall_projectile{
	dir = 4
	},
/turf/open/floor/naturalstone,
/area/rogue/under/tomb)
"OV" = (
/obj/effect/decal/cleanable/dirt/dust,
/turf/open/floor/cobble,
/area/rogue/under/tomb/indoors/rest)
"Qi" = (
/obj/effect/decal/shadow_floor{
	dir = 4
	},
/obj/structure/fluff/railing/wood{
	dir = 4;
	pixel_y = 8
	},
/turf/open/floor/cobble,
/area/rogue/under/tomb/indoors/rest)
"RA" = (
/obj/effect/decal/shadow_floor{
	dir = 1
	},
/obj/effect/decal/cleanable/dirt/dust,
/turf/open/floor/cobble,
/area/rogue/under/tomb/indoors/rest)
"RR" = (
/turf/closed/wall/mineral/decostone/cand,
/area/rogue/under/tomb/indoors)
"Sb" = (
/obj/effect/decal/cleanable/dirt/dust,
/turf/open/floor/carpet/purple,
/area/rogue/under/tomb/indoors/rest)
"SR" = (
/obj/structure/rack,
/obj/item/cooking/pan,
/turf/open/floor/wood,
/area/rogue/under/tomb/indoors/rest)
"ST" = (
/obj/effect/decal/cleanable/dirt/dust,
/obj/machinery/light/fueled/wallfire/candle/r,
/turf/open/floor/wood,
/area/rogue/under/tomb/indoors/rest)
"Ts" = (
/turf/open/transparent/openspace,
/area/rogue/under/tomb/indoors/rest)
"Uv" = (
/obj/structure/rack/shelf/big{
	pixel_y = 0
	},
/obj/item/reagent_containers/glass/bucket/wooden{
	pixel_x = 5
	},
/obj/item/natural/cloth{
	pixel_x = -4;
	pixel_y = 5
	},
/obj/effect/decal/cleanable/dirt/dust,
/turf/open/floor/blocks,
/area/rogue/under/tomb/indoors/rest)
"UY" = (
/obj/machinery/light/fueled/hearth/big_fireplace{
	pixel_x = -32
	},
/turf/closed/wall/mineral/stone,
/area/rogue/under/tomb/indoors/rest)
"Vd" = (
/obj/machinery/light/fueled/cauldron,
/obj/effect/decal/cleanable/dirt/dust,
/turf/open/floor/blocks/green,
/area/rogue/under/tomb/indoors/rest)
"VA" = (
/obj/effect/dungeon_directional_helper/west,
/turf/open/floor/naturalstone,
/area/rogue/under/tomb)
"Wx" = (
/turf/closed/mineral/bedrock,
/area/rogue/under/tomb)
"Xi" = (
/turf/closed/wall/mineral/decostone,
/area/rogue/under/tomb/indoors)
"XA" = (
/obj/structure/roguerock,
/turf/open/floor/cobblerock,
/area/rogue/under/tomb)
"XQ" = (
/turf/closed/wall/mineral/craftstone,
/area/rogue/under/tomb/indoors/rest)
"Yt" = (
/turf/open/floor/herringbone,
/area/rogue/under/tomb/indoors)
"Yy" = (
/obj/structure/table/stone_small,
/obj/item/pestle,
/obj/effect/decal/cleanable/dirt/dust,
/turf/open/floor/cobble,
/area/rogue/under/tomb/indoors/rest)

(1,1,1) = {"
Wx
Wx
Wx
Wx
Wx
Wx
Wx
Wx
kS
ma
ma
ma
cO
VA
cO
cO
cO
Wx
Wx
Wx
"}
(2,1,1) = {"
Wx
Wx
Wx
Wx
Wx
Wx
Wx
DV
kS
ma
ma
cO
cO
cO
cO
cO
Wx
Wx
Wx
Wx
"}
(3,1,1) = {"
Wx
Wx
Wx
Wx
Wx
Wx
Wx
Wx
Wx
kS
ma
cO
wO
cO
cO
cO
Wx
Wx
Wx
Wx
"}
(4,1,1) = {"
Wx
Wx
Wx
Wx
Wx
Wx
Wx
Wx
Wx
kS
cO
cO
cO
cO
cO
cO
Wx
Wx
Wx
Wx
"}
(5,1,1) = {"
Wx
Wx
Wx
Wx
Wx
Wx
Wx
Wx
cO
cO
cO
cO
Wx
cO
cO
Wx
Wx
Wx
Wx
Wx
"}
(6,1,1) = {"
Wx
Wx
Wx
Wx
Wx
Wx
Wx
ma
cO
cO
wO
cO
Wx
cO
cO
Wx
Wx
Wx
Wx
Wx
"}
(7,1,1) = {"
Wx
Wx
DV
Wx
Wx
Wx
kS
ma
ma
cO
cO
cO
cO
cO
kS
Wx
HY
HY
XA
Wx
"}
(8,1,1) = {"
Wx
Wx
kS
Wx
ma
ma
ma
ma
Wx
cO
cO
cO
cO
cO
kS
Wx
Wx
HY
HY
Wx
"}
(9,1,1) = {"
ma
ma
ma
ma
ma
ma
cO
ma
cO
cO
cO
cO
cO
kS
ma
Wx
Wx
HY
Wx
Wx
"}
(10,1,1) = {"
zV
ma
ma
ma
ma
ma
cO
cO
cO
cO
cO
cO
cO
ma
ma
Wx
HY
HY
Wx
Wx
"}
(11,1,1) = {"
ma
cO
cO
cO
cO
cO
cO
lm
Fu
bD
cO
cO
cO
ma
ma
kS
ma
Wx
Wx
Wx
"}
(12,1,1) = {"
Fv
Fv
Fv
Fv
Fv
cO
cO
sE
wk
nY
cO
cO
ma
ma
Wx
kS
Wx
Wx
Wx
Wx
"}
(13,1,1) = {"
Fv
zS
Yy
zu
Fv
Fv
Fv
Fv
Fv
FS
cO
cO
ma
Wx
Wx
kS
kS
Wx
Wx
Wx
"}
(14,1,1) = {"
Fv
pS
pS
nq
zx
zf
cy
zf
Fv
cO
cO
cO
ma
Wx
iO
kS
DV
Wx
Wx
Wx
"}
(15,1,1) = {"
Fv
Vd
Kv
nq
qJ
sq
zf
zf
vC
cO
cO
cO
ma
Wx
Wx
Wx
Wx
Wx
Wx
Wx
"}
(16,1,1) = {"
Fv
Kv
Kv
OV
Fv
Fv
Fv
Fv
Fv
cO
cO
cO
cO
ma
Wx
Wx
Wx
Wx
Wx
Wx
"}
(17,1,1) = {"
Fv
NS
OV
OV
kt
Fv
ci
MR
Fv
cO
cO
cO
cO
cO
Wx
Wx
Wx
Wx
Wx
Wx
"}
(18,1,1) = {"
Fv
nq
OV
Ch
kt
FO
sq
hd
Fv
cO
cO
cO
cO
cO
kS
Wx
Wx
Wx
Wx
Wx
"}
(19,1,1) = {"
Fv
nq
wu
Fv
Jr
Fv
sq
Uv
Fv
cO
cO
cO
cO
cO
Wx
Wx
Wx
Wx
Wx
Wx
"}
(20,1,1) = {"
Fv
Fv
Fv
Fv
Fv
Fv
Fv
Fv
Fv
cO
cO
bT
cO
cO
Wx
Wx
Wx
Wx
Wx
Wx
"}

(1,1,2) = {"
Wx
Wx
Wx
Wx
Wx
Wx
Wx
Wx
Wx
HY
HY
cO
cO
LQ
LQ
LQ
LQ
Wx
Wx
Wx
"}
(2,1,2) = {"
Wx
Wx
Wx
Wx
DV
Wx
Wx
Wx
Wx
Wx
HY
cO
cO
LQ
LQ
LQ
Wx
Wx
Wx
Wx
"}
(3,1,2) = {"
Wx
Wx
Wx
Wx
iU
kS
XA
Wx
Wx
Wx
XA
cO
cO
cO
LQ
LQ
Wx
Wx
Wx
Wx
"}
(4,1,2) = {"
Wx
Wx
Wx
Wx
kS
eA
HY
Wx
Wx
Wx
Wx
cO
HY
cO
wO
LQ
Wx
Wx
Wx
Wx
"}
(5,1,2) = {"
Wx
Wx
Wx
Wx
ma
ma
ma
Wx
Wx
Wx
Wx
HY
XA
HY
cO
Wx
Wx
Wx
Wx
Wx
"}
(6,1,2) = {"
Wx
Wx
Wx
Wx
ma
cO
ma
ma
Wx
Wx
Wx
HY
HY
cO
cO
Wx
Wx
Wx
Wx
Wx
"}
(7,1,2) = {"
Wx
Wx
Wx
Wx
cO
Wx
Wx
ma
cO
LQ
Wx
cO
XA
cO
cO
cO
LQ
LQ
LQ
Wx
"}
(8,1,2) = {"
Wx
cO
cO
Wx
LQ
Wx
Wx
cO
cO
LQ
LQ
cO
cO
Wx
Wx
Wx
Wx
LQ
LQ
Wx
"}
(9,1,2) = {"
cO
cO
cO
LQ
LQ
LQ
Wx
cO
LQ
LQ
LQ
LQ
cO
Wx
Wx
Wx
Wx
Wx
Wx
Wx
"}
(10,1,2) = {"
cO
cO
cO
cO
LQ
LQ
cO
cO
LQ
LQ
LQ
LQ
LQ
LQ
Wx
Wx
Xi
pG
Xi
Wx
"}
(11,1,2) = {"
cO
cO
cO
LQ
LQ
LQ
LQ
LQ
LQ
LQ
LQ
LQ
Wx
Wx
Wx
Xi
RR
DY
RR
Xi
"}
(12,1,2) = {"
Fv
Fv
Fv
Fv
Fv
LQ
LQ
LQ
LQ
LQ
LQ
LQ
Wx
Wx
Wx
Xi
hO
AO
oL
Xi
"}
(13,1,2) = {"
Fv
Fv
tt
dH
Fv
Fv
Fv
Fv
Fv
LQ
LQ
LQ
Wx
Wx
Wx
Xi
Yt
nJ
JP
Xi
"}
(14,1,2) = {"
Fv
UY
tt
tt
tt
tt
yx
ra
Fv
LQ
LQ
LQ
LQ
Wx
Wx
Xi
MY
AO
Yt
Xi
"}
(15,1,2) = {"
Fv
SR
tt
go
tt
ST
Cq
tt
Fv
LQ
LQ
LQ
LQ
Wx
Wx
Xi
Xi
ux
Xi
Xi
"}
(16,1,2) = {"
Fv
tt
Cq
Sb
tt
XQ
XQ
yV
Fv
LQ
LQ
LQ
LQ
LQ
Wx
Wx
cO
Ob
cO
Wx
"}
(17,1,2) = {"
Fv
Cq
Cb
xJ
xJ
XQ
te
tC
Fv
LQ
LQ
LQ
LQ
LQ
Wx
Wx
Wx
cO
Wx
Wx
"}
(18,1,2) = {"
Fv
Cq
KJ
Qi
iV
XQ
jy
Oa
Fv
LQ
LQ
LQ
LQ
LQ
LQ
cO
cO
cO
Wx
Wx
"}
(19,1,2) = {"
Fv
Gi
Ts
zN
RA
XQ
xA
EG
Fv
LQ
LQ
LQ
LQ
LQ
Wx
Wx
Wx
cO
Wx
Wx
"}
(20,1,2) = {"
Fv
Fv
Fv
Fv
Fv
Fv
Fv
Fv
Fv
LQ
LQ
LQ
LQ
LQ
Wx
Wx
Wx
qb
Wx
Wx
"}
