//MAP CONVERTED BY dmm2tgm.py THIS HEADER COMMENT PREVENTS RECONVERSION, DO NOT REMOVE
"an" = (
/obj/structure/flora/newtree/scorched,
/turf/open/floor/dirt,
/area/rogue/under/tomb/cave/lava)
"bA" = (
/obj/structure/noose/gallows,
/turf/open/floor/ruinedwood/darker,
/area/rogue/under/tomb/cave/lava)
"bJ" = (
/obj/machinery/light/fueled/campfire/densefire,
/turf/open/floor/naturalstone,
/area/rogue/under/tomb/cave/lava)
"da" = (
/obj/effect/dungeon_directional_helper/north,
/turf/open/floor/cobblerock,
/area/rogue/under/tomb/cave/lava)
"dk" = (
/turf/closed/wall/mineral/tent,
/area/rogue/under/tomb/indoors)
"dv" = (
/obj/effect/dungeon_directional_helper/east,
/turf/open/floor/dirt/road,
/area/rogue/under/tomb/cave/lava)
"dY" = (
/obj/structure/fluff/railing/border{
	dir = 4
	},
/turf/open/lava/acid,
/area/rogue/under/tomb/cave/lava)
"eK" = (
/turf/open/floor/cobblerock/alt,
/area/rogue/under/tomb/cave/lava)
"fK" = (
/obj/structure/flora/newtree/scorched,
/turf/open/transparent/openspace,
/area/rogue/under/tomb/cave/lava)
"hC" = (
/obj/structure/fluff/railing/border{
	dir = 8
	},
/turf/open/lava/acid,
/area/rogue/under/tomb/cave/lava)
"hE" = (
/turf/open/floor/dirt,
/area/rogue/under/tomb/indoors)
"hK" = (
/obj/machinery/light/fueled/campfire,
/turf/open/floor/naturalstone,
/area/rogue/under/tomb/indoors)
"ih" = (
/obj/structure/fluff/railing/border{
	dir = 1
	},
/turf/open/floor/naturalstone,
/area/rogue/under/tomb/cave/lava)
"it" = (
/obj/structure/closet/crate/chest/neu,
/obj/item/sleepingbag,
/obj/item/sleepingbag,
/obj/effect/spawner/map_spawner/loot/food,
/obj/effect/spawner/map_spawner/loot/food,
/turf/open/floor/naturalstone,
/area/rogue/under/tomb/cave/lava)
"jt" = (
/obj/structure/roguetent,
/turf/open/floor/cobblerock,
/area/rogue/under/tomb/indoors)
"jA" = (
/obj/structure/fluff/railing/border{
	dir = 10
	},
/turf/open/floor/dirt,
/area/rogue/under/tomb/cave/lava)
"jJ" = (
/turf/open/water/swamp/deep,
/area/rogue/under/tomb/cave/lava)
"jL" = (
/obj/structure/bed/shit,
/turf/open/floor/dirt,
/area/rogue/under/tomb/indoors)
"jO" = (
/turf/open/floor/naturalstone,
/area/rogue/under/tomb/cave/lava)
"kG" = (
/obj/structure/fluff/railing/border{
	dir = 5
	},
/turf/open/floor/naturalstone,
/area/rogue/under/tomb/cave/lava)
"lt" = (
/obj/structure/fluff/railing/border,
/turf/open/floor/naturalstone,
/area/rogue/under/tomb/cave/lava)
"lE" = (
/turf/open/floor/cobblerock,
/area/rogue/under/tomb/indoors)
"me" = (
/turf/open/floor/metal{
	icon_state = "plating2"
	},
/area/rogue/under/tomb/cave/lava)
"mE" = (
/turf/open/floor/cobblerock,
/area/rogue/under/tomb/cave/lava)
"mV" = (
/obj/structure/fluff/railing/border{
	dir = 6
	},
/turf/open/floor/naturalstone,
/area/rogue/under/tomb/cave/lava)
"nm" = (
/mob/living/carbon/human/species/rousman/ambush,
/turf/open/floor/cobblerock,
/area/rogue/under/tomb/cave/lava)
"np" = (
/obj/structure/closet/crate/chest/wicker,
/obj/effect/spawner/map_spawner/loot,
/obj/effect/spawner/map_spawner/loot,
/turf/open/floor/dirt,
/area/rogue/under/tomb/indoors)
"nJ" = (
/obj/structure/table/church/m,
/obj/item/clothing/neck/psycross/silver/ravox,
/turf/open/floor/churchmarble,
/area/rogue/under/tomb/cave/lava)
"nR" = (
/obj/structure/fluff/railing/border{
	dir = 5
	},
/obj/structure/fluff/railing/border{
	dir = 9
	},
/obj/structure/stairs{
	dir = 1
	},
/turf/open/floor/cobblerock,
/area/rogue/under/tomb/cave/lava)
"oW" = (
/turf/closed/wall/mineral/stone/window,
/area/rogue/under/tomb/cave/lava)
"pO" = (
/turf/open/floor/churchmarble,
/area/rogue/under/tomb/cave/lava)
"qe" = (
/obj/structure/table/church{
	dir = 1
	},
/turf/open/floor/churchmarble,
/area/rogue/under/tomb/cave/lava)
"qx" = (
/obj/structure/table/church,
/obj/effect/spawner/map_spawner/loot/weapon,
/turf/open/floor/churchmarble,
/area/rogue/under/tomb/cave/lava)
"qX" = (
/obj/machinery/light/fueled/firebowl/stump,
/turf/open/floor/dirt/road,
/area/rogue/under/tomb/cave/lava)
"qZ" = (
/obj/structure/fluff/railing/border{
	dir = 9
	},
/turf/open/floor/naturalstone,
/area/rogue/under/tomb/cave/lava)
"rA" = (
/obj/effect/spawner/map_spawner/loot/weapon,
/turf/open/floor/cobblerock,
/area/rogue/under/tomb/cave/lava)
"sb" = (
/mob/living/carbon/human/species/rousman/ambush,
/turf/open/floor/cobble,
/area/rogue/under/tomb/cave/lava)
"sp" = (
/turf/open/floor/dirt,
/area/rogue/under/tomb/cave/lava)
"sX" = (
/obj/structure/roguetent,
/turf/open/floor/dirt,
/area/rogue/under/tomb/indoors)
"uk" = (
/mob/living/carbon/human/species/rousman/ambush,
/turf/open/floor/dirt/road,
/area/rogue/under/tomb/cave/lava)
"uw" = (
/mob/living/carbon/human/species/rousman/ambush,
/turf/open/floor/metal,
/area/rogue/under/tomb/cave/lava)
"uE" = (
/obj/structure/fluff/railing/border{
	dir = 9
	},
/turf/open/floor/cobblerock,
/area/rogue/under/tomb/cave/lava)
"wr" = (
/obj/effect/dungeon_directional_helper/south,
/turf/open/floor/dirt/road,
/area/rogue/under/tomb/cave/lava)
"yp" = (
/turf/open/transparent/openspace,
/area/rogue/under/tomb/cave/lava)
"zf" = (
/mob/living/carbon/human/species/rousman/ambush,
/turf/open/floor/cobblerock,
/area/rogue/under/tomb/indoors)
"zW" = (
/obj/machinery/light/fueled/campfire/pyre,
/turf/open/floor/churchmarble,
/area/rogue/under/tomb/cave/lava)
"AG" = (
/obj/structure/bed/shit,
/turf/open/floor/naturalstone,
/area/rogue/under/tomb/indoors)
"Ce" = (
/turf/closed/mineral/bedrock,
/area/rogue/under/tomb/cave/lava)
"Cj" = (
/turf/open/lava/acid,
/area/rogue/under/tomb/cave/lava)
"Dw" = (
/obj/structure/flora/newtree/scorched,
/turf/open/floor/naturalstone,
/area/rogue/under/tomb/cave/lava)
"FD" = (
/mob/living/carbon/human/species/rousman/ambush,
/turf/open/floor/ruinedwood/darker,
/area/rogue/under/tomb/cave/lava)
"FI" = (
/obj/effect/dungeon_directional_helper/west,
/turf/open/floor/naturalstone,
/area/rogue/under/tomb/cave/lava)
"FK" = (
/obj/machinery/light/fueled/torchholder/r,
/turf/open/floor/dirt,
/area/rogue/under/tomb/indoors)
"Gf" = (
/obj/structure/fluff/railing/border{
	dir = 4
	},
/turf/open/floor/naturalstone,
/area/rogue/under/tomb/cave/lava)
"Gk" = (
/obj/machinery/light/fueled/hearth,
/turf/open/floor/naturalstone,
/area/rogue/under/tomb/cave/lava)
"Gs" = (
/obj/structure/chair/stool,
/turf/open/floor/naturalstone,
/area/rogue/under/tomb/cave/lava)
"Hq" = (
/mob/living/carbon/human/species/rousman/ambush,
/turf/open/floor/dirt,
/area/rogue/under/tomb/indoors)
"Hs" = (
/obj/effect/spawner/map_spawner/loot/weapon,
/turf/open/floor/naturalstone,
/area/rogue/under/tomb/cave/lava)
"HQ" = (
/turf/open/floor/cobble,
/area/rogue/under/tomb/cave/lava)
"HZ" = (
/obj/structure/closet/crate/chest/wicker,
/obj/effect/spawner/map_spawner/loot,
/obj/effect/spawner/map_spawner/loot,
/obj/item/clothing/shoes/boots,
/turf/open/floor/dirt,
/area/rogue/under/tomb/indoors)
"Ib" = (
/turf/open/water/cleanshallow,
/area/rogue/under/tomb/cave/lava)
"Ie" = (
/mob/living/carbon/human/species/rousman/ambush,
/turf/open/floor/naturalstone,
/area/rogue/under/tomb/cave/lava)
"ID" = (
/obj/structure/flora/grass/water/reeds,
/turf/open/water/swamp,
/area/rogue/under/tomb/cave/lava)
"IU" = (
/obj/machinery/light/fueled/firebowl/stump,
/turf/open/floor/cobblerock,
/area/rogue/under/tomb/cave/lava)
"NB" = (
/obj/structure/fluff/railing/border{
	dir = 10
	},
/turf/open/floor/naturalstone,
/area/rogue/under/tomb/cave/lava)
"NM" = (
/obj/item/statue/gold,
/turf/open/floor/cobble,
/area/rogue/under/tomb/cave/lava)
"Ou" = (
/obj/item/bin/water/gross,
/turf/open/floor/naturalstone,
/area/rogue/under/tomb/indoors)
"Ow" = (
/turf/open/floor/dirt/road,
/area/rogue/under/tomb/cave/lava)
"OY" = (
/obj/effect/spawner/map_spawner/loot/weapon,
/turf/open/floor/cobble,
/area/rogue/under/tomb/cave/lava)
"Ps" = (
/turf/open/floor/naturalstone,
/area/rogue/under/tomb/indoors)
"Rs" = (
/obj/structure/fluff/railing/border,
/turf/open/floor/dirt,
/area/rogue/under/tomb/cave/lava)
"Rw" = (
/obj/structure/fluff/railing/border{
	dir = 6
	},
/turf/open/floor/cobblerock,
/area/rogue/under/tomb/cave/lava)
"RM" = (
/turf/open/water/swamp,
/area/rogue/under/tomb/cave/lava)
"RN" = (
/obj/structure/fluff/railing/border,
/turf/open/lava/acid,
/area/rogue/under/tomb/cave/lava)
"SW" = (
/obj/structure/fluff/railing/border{
	dir = 1
	},
/turf/open/lava/acid,
/area/rogue/under/tomb/cave/lava)
"To" = (
/obj/machinery/light/fueled/firebowl/stump,
/turf/open/floor/dirt,
/area/rogue/under/tomb/cave/lava)
"TI" = (
/turf/open/floor/churchrough,
/area/rogue/under/tomb/cave/lava)
"TW" = (
/obj/structure/flora/grass/water/reeds,
/turf/open/water/swamp/deep,
/area/rogue/under/tomb/cave/lava)
"Uc" = (
/obj/structure/fluff/railing/border{
	dir = 8
	},
/turf/open/floor/cobblerock,
/area/rogue/under/tomb/cave/lava)
"Ul" = (
/obj/structure/fluff/railing/border{
	dir = 8
	},
/turf/open/floor/naturalstone,
/area/rogue/under/tomb/cave/lava)
"UW" = (
/obj/effect/spawner/map_spawner/loot/medium,
/turf/open/floor/cobble,
/area/rogue/under/tomb/cave/lava)
"VO" = (
/obj/machinery/light/fueled/firebowl/stump,
/turf/open/floor/naturalstone,
/area/rogue/under/tomb/cave/lava)
"Wk" = (
/turf/open/floor/ruinedwood/darker,
/area/rogue/under/tomb/cave/lava)
"Wm" = (
/obj/structure/fluff/railing/border{
	dir = 1
	},
/turf/open/floor/cobblerock,
/area/rogue/under/tomb/cave/lava)
"WC" = (
/obj/structure/fluff/railing/border{
	dir = 10
	},
/turf/open/floor/cobblerock,
/area/rogue/under/tomb/cave/lava)
"WS" = (
/turf/open/floor/metal,
/area/rogue/under/tomb/cave/lava)
"WU" = (
/obj/structure/chair/stool,
/turf/open/floor/churchrough,
/area/rogue/under/tomb/cave/lava)
"WY" = (
/turf/closed/mineral/bedrock,
/area/rogue/under/tomb/indoors)
"YK" = (
/obj/structure/fluff/railing/border,
/turf/open/floor/cobblerock,
/area/rogue/under/tomb/cave/lava)

(1,1,1) = {"
Ce
Ce
Ce
Ce
Ce
Ce
Ce
Ce
Ce
Ce
Ce
Ce
Ce
mE
mE
FI
jO
Ce
Ce
Ce
Ce
Ce
Ce
Ce
Ce
Ce
Ce
Ce
Ce
Ce
"}
(2,1,1) = {"
Ce
Ce
Ce
Ce
Ce
Ce
Ce
Ce
Ce
jO
jO
jO
mE
mE
mE
mE
mV
Gf
dY
dY
dY
dY
dY
dY
kG
Ce
Ce
Ce
Ce
Ce
"}
(3,1,1) = {"
Ce
Ce
Ce
Ce
Ce
Ce
Rw
Gf
Gf
Gf
kG
VO
mE
mE
mE
jO
jO
HQ
HQ
HQ
HQ
HQ
HQ
HQ
jO
jO
Ce
Ce
Ce
Ce
"}
(4,1,1) = {"
Ce
Ce
Ce
Ce
Ce
Ce
YK
Wk
Wk
Wk
Wm
mE
mE
mE
mE
mE
jO
me
me
me
me
me
me
me
mE
mE
jO
Ce
Ce
Ce
"}
(5,1,1) = {"
Ce
Ce
Ce
Ce
RM
sp
YK
Wk
bA
Wk
nR
mE
mE
mE
mE
mE
mE
HQ
HQ
HQ
HQ
HQ
HQ
HQ
mE
mE
jO
jO
Ce
Ce
"}
(6,1,1) = {"
Ce
Ce
Ce
RM
RM
RM
Rs
Wk
Wk
FD
Wm
mE
mE
jO
jO
mE
WC
Ul
hC
hC
hC
hC
hC
Ul
qZ
mE
nm
jO
Ce
Ce
"}
(7,1,1) = {"
Ce
WY
dk
dk
dk
dk
jA
Ul
Ul
Uc
uE
mE
jO
jO
jO
Ie
jO
jO
jO
Cj
Cj
Cj
Cj
Cj
jO
IU
mE
jO
jO
Ce
"}
(8,1,1) = {"
Ce
WY
dk
HZ
np
dk
sp
jO
mE
mE
mE
jO
jO
Gk
oW
oW
jO
jO
jO
Cj
Cj
Cj
Cj
Cj
jO
jO
jO
Dw
jO
Ce
"}
(9,1,1) = {"
Ce
dk
dk
hE
hE
sX
sp
mE
mE
mE
jO
mE
mE
Gk
oW
oW
mE
mE
jO
jO
Cj
Cj
Cj
Cj
Cj
jO
jO
jO
jO
Ce
"}
(10,1,1) = {"
Ce
dk
jL
Hq
FK
dk
mE
mE
nm
mE
jO
mE
mE
mE
jO
jO
mE
mE
IU
jO
jO
Cj
Cj
Cj
Cj
Cj
jO
mE
Ce
Ce
"}
(11,1,1) = {"
Ce
dk
jL
hE
dk
dk
mE
mE
mE
jO
jO
jO
mE
mE
jO
jO
mE
mE
mE
jO
Cj
Cj
Cj
Cj
Cj
Cj
jO
mE
Ce
Ce
"}
(12,1,1) = {"
Ce
dk
dk
dk
dk
mE
mE
jO
jO
jO
jO
jO
jO
Cj
Cj
Cj
Cj
jO
jO
Cj
Cj
Cj
Cj
Cj
Cj
jO
jO
jO
Ce
Ce
"}
(13,1,1) = {"
jO
mE
mE
mE
mE
mE
jO
oW
oW
VO
jO
Cj
Cj
Cj
Cj
Cj
Cj
Cj
Cj
Cj
Cj
Cj
Cj
Cj
jO
jO
jO
sp
sp
Ce
"}
(14,1,1) = {"
mE
mE
mE
mE
mE
mE
jO
oW
oW
jO
Cj
Cj
Cj
Cj
oW
oW
Cj
Cj
Cj
Cj
Cj
Cj
oW
oW
jO
jO
sp
sp
Ow
Ow
"}
(15,1,1) = {"
da
mE
mE
mE
mE
mE
jO
jO
jO
Cj
Cj
Cj
Cj
Cj
Cj
Cj
Cj
Cj
Cj
Cj
Cj
Cj
oW
jO
jO
sp
sp
Ow
eK
Ow
"}
(16,1,1) = {"
mE
mE
mE
IU
mE
mE
mE
jO
jO
Cj
Cj
Cj
Cj
Cj
jO
jO
jO
Cj
Cj
Cj
Cj
jO
jO
sp
sp
Ow
Ow
eK
eK
wr
"}
(17,1,1) = {"
mE
mE
jO
mV
mE
mE
mE
kG
jO
Cj
Cj
Cj
Cj
jO
jO
mE
mE
mE
jO
jO
jO
sp
sp
sp
Ow
qX
Ow
eK
eK
Ow
"}
(18,1,1) = {"
Ce
jO
jO
lt
HQ
WS
HQ
ih
jO
Cj
Cj
Cj
jO
jO
mE
mE
mE
jO
jO
sp
sp
sp
sp
Ow
Ow
Ow
uk
eK
eK
sp
"}
(19,1,1) = {"
Ce
Cj
Cj
lt
HQ
WS
HQ
ih
jO
Cj
Cj
Cj
jO
jO
jO
mE
jO
jO
sp
an
sp
sp
Ow
Ow
Ow
sp
sp
sp
sp
Ce
"}
(20,1,1) = {"
Ce
Cj
Cj
RN
HQ
WS
HQ
ih
Cj
Cj
Cj
Cj
jO
jO
oW
oW
jO
sp
sp
sp
sp
sp
eK
eK
sp
sp
an
sp
Ce
Ce
"}
(21,1,1) = {"
Ce
Cj
Cj
RN
HQ
WS
HQ
SW
Cj
Cj
Cj
Cj
jO
jO
oW
oW
sp
To
sp
sp
sp
eK
eK
eK
sp
sp
sp
Ce
Ce
Ce
"}
(22,1,1) = {"
Ce
Cj
Cj
RN
HQ
uw
HQ
SW
Cj
Cj
Cj
jO
jO
jO
sp
sp
sp
sp
sp
Ow
eK
eK
eK
sp
sp
RM
Ce
Ce
Ce
Ce
"}
(23,1,1) = {"
Ce
Cj
Cj
RN
HQ
WS
HQ
SW
Cj
jO
jO
jO
RM
RM
RM
RM
sp
an
Ow
Ow
eK
eK
sp
sp
sp
RM
Ce
Ce
Ce
Ce
"}
(24,1,1) = {"
Ce
Cj
Cj
RN
HQ
WS
HQ
ih
jO
jO
jO
RM
RM
jJ
jJ
RM
sp
eK
Ow
Ow
sp
To
sp
an
sp
Ce
Ce
Ce
Ce
Ce
"}
(25,1,1) = {"
Ce
Cj
Cj
RN
HQ
WS
HQ
ih
jO
jO
RM
RM
jJ
TW
jJ
RM
eK
eK
Ow
sp
sp
sp
sp
ID
Ce
Ce
Ce
Ce
Ce
Ce
"}
(26,1,1) = {"
Ce
Cj
jO
lt
HQ
WS
HQ
ih
mE
mE
RM
TW
jJ
jJ
RM
RM
eK
eK
sp
an
sp
RM
RM
RM
Ce
Ce
Ce
Ce
Ce
Ce
"}
(27,1,1) = {"
Ce
Ce
jO
NB
jO
jO
jO
uE
nm
mE
RM
RM
jJ
RM
RM
uk
Ow
Ow
sp
sp
sp
ID
Ce
Ce
Ce
Ce
Ce
Ce
Ce
Ce
"}
(28,1,1) = {"
Ce
Ce
Ce
jO
VO
mE
mE
mE
mE
mE
mE
RM
RM
RM
sp
Ow
Ow
sp
sp
Ce
Ce
Ce
Ce
Ce
Ce
Ce
Ce
Ce
Ce
Ce
"}
(29,1,1) = {"
Ce
Ce
Ce
Ce
jO
jO
mE
mE
jO
jO
mE
mE
mE
mE
Ow
Ow
Ow
sp
Ce
Ce
Ce
Ce
Ce
Ce
Ce
Ce
Ce
Ce
Ce
Ce
"}
(30,1,1) = {"
Ce
Ce
Ce
Ce
Ce
Ce
Ce
Ce
Ce
Ce
Ce
Ce
Ce
sp
Ow
dv
sp
Ce
Ce
Ce
Ce
Ce
Ce
Ce
Ce
Ce
Ce
Ce
Ce
Ce
"}

(1,1,2) = {"
WY
WY
WY
WY
WY
WY
Ce
Ce
Ce
Ce
Ce
Ce
Ce
jO
jO
jO
jO
Ce
Ce
Ce
Ce
Ce
Ce
Ce
Ce
Ce
Ce
Ce
Ce
Ce
"}
(2,1,2) = {"
WY
WY
AG
lE
lE
dk
Ce
Ce
Ce
yp
yp
jO
mE
jO
mE
mE
jO
mE
mE
mE
yp
yp
yp
yp
yp
jO
Ib
Ib
Ce
Ce
"}
(3,1,2) = {"
WY
Ou
lE
lE
lE
dk
yp
yp
yp
yp
yp
yp
mE
jO
jO
mE
mE
jO
jO
yp
yp
yp
yp
yp
yp
yp
jO
Ib
Ib
Ce
"}
(4,1,2) = {"
WY
AG
lE
zf
dk
dk
yp
yp
yp
yp
yp
yp
yp
yp
HQ
HQ
yp
yp
yp
yp
yp
yp
yp
yp
yp
yp
yp
jO
jO
Ce
"}
(5,1,2) = {"
WY
Ps
hK
Ps
dk
yp
yp
yp
yp
yp
yp
yp
yp
yp
mE
HQ
yp
yp
yp
yp
yp
yp
yp
yp
yp
yp
yp
yp
Ce
Ce
"}
(6,1,2) = {"
WY
hK
Ps
lE
dk
yp
yp
yp
yp
yp
yp
yp
yp
yp
mE
HQ
yp
yp
yp
yp
yp
yp
yp
yp
yp
yp
yp
yp
Ce
Ce
"}
(7,1,2) = {"
WY
WY
dk
jt
dk
jO
yp
yp
yp
yp
yp
yp
yp
HQ
sb
HQ
yp
yp
yp
yp
yp
yp
yp
yp
yp
yp
yp
yp
yp
Ce
"}
(8,1,2) = {"
Ce
Ce
mE
mE
jO
mE
yp
yp
yp
yp
yp
yp
yp
HQ
HQ
HQ
HQ
yp
yp
yp
yp
yp
yp
yp
yp
yp
yp
yp
yp
Ce
"}
(9,1,2) = {"
Ce
mE
mE
mE
jO
mE
yp
yp
yp
yp
yp
yp
HQ
HQ
HQ
HQ
HQ
HQ
yp
yp
yp
yp
yp
yp
yp
yp
yp
yp
yp
Ce
"}
(10,1,2) = {"
Ce
mE
mE
mE
mE
jO
yp
yp
yp
yp
yp
HQ
HQ
HQ
HQ
yp
rA
mE
HQ
yp
yp
yp
yp
yp
yp
yp
yp
yp
Ce
Ce
"}
(11,1,2) = {"
Ce
mE
Ie
mE
mE
jO
yp
yp
yp
yp
HQ
HQ
HQ
yp
HQ
HQ
mE
mE
mE
HQ
yp
yp
yp
yp
yp
yp
yp
yp
Ce
Ce
"}
(12,1,2) = {"
Ce
mE
jO
mE
mE
yp
yp
yp
yp
HQ
HQ
HQ
HQ
HQ
yp
HQ
yp
mE
mE
HQ
HQ
HQ
yp
yp
yp
yp
yp
sp
Ce
Ce
"}
(13,1,2) = {"
mE
jO
mE
yp
yp
yp
yp
HQ
HQ
HQ
HQ
HQ
yp
yp
yp
yp
yp
yp
HQ
yp
yp
HQ
HQ
yp
yp
yp
yp
sp
sp
Ce
"}
(14,1,2) = {"
mE
jO
mE
jO
jO
jO
HQ
HQ
HQ
HQ
HQ
yp
HQ
yp
NM
NM
yp
HQ
yp
UW
HQ
HQ
HQ
HQ
yp
yp
yp
sp
sp
sp
"}
(15,1,2) = {"
mE
mE
jO
HQ
sb
HQ
yp
yp
HQ
HQ
HQ
yp
HQ
yp
yp
yp
yp
HQ
HQ
HQ
HQ
yp
HQ
yp
yp
yp
yp
sp
Ow
Ow
"}
(16,1,2) = {"
mE
mE
jO
yp
yp
yp
yp
yp
yp
HQ
HQ
HQ
HQ
yp
HQ
OY
HQ
HQ
yp
HQ
yp
yp
yp
yp
yp
mE
mE
mE
Ow
Ow
"}
(17,1,2) = {"
jO
mE
jO
yp
yp
yp
yp
yp
yp
yp
HQ
HQ
HQ
HQ
HQ
yp
yp
HQ
HQ
HQ
yp
yp
yp
yp
HQ
HQ
HQ
Ow
Ow
Ow
"}
(18,1,2) = {"
Ce
mE
yp
yp
yp
yp
yp
yp
yp
yp
yp
HQ
HQ
HQ
yp
mE
mE
mE
HQ
yp
yp
yp
yp
yp
yp
yp
yp
Ow
sp
sp
"}
(19,1,2) = {"
Ce
jO
yp
yp
yp
yp
yp
yp
yp
yp
yp
yp
HQ
HQ
HQ
HQ
yp
HQ
yp
yp
yp
yp
yp
yp
yp
yp
yp
sp
sp
Ce
"}
(20,1,2) = {"
Ce
yp
yp
yp
yp
yp
yp
yp
yp
yp
yp
yp
yp
sb
HQ
HQ
HQ
yp
yp
yp
yp
yp
yp
yp
yp
yp
yp
sp
Ce
Ce
"}
(21,1,2) = {"
Ce
yp
yp
yp
yp
yp
yp
yp
yp
yp
yp
yp
yp
HQ
HQ
HQ
yp
yp
yp
yp
yp
yp
yp
yp
yp
yp
yp
Ce
Ce
Ce
"}
(22,1,2) = {"
Ce
yp
yp
yp
yp
yp
yp
yp
yp
yp
yp
yp
yp
yp
HQ
yp
yp
yp
yp
yp
yp
yp
yp
yp
yp
yp
jO
jO
Ce
Ce
"}
(23,1,2) = {"
Ce
yp
yp
yp
yp
yp
yp
yp
yp
yp
yp
yp
yp
yp
HQ
yp
yp
yp
yp
yp
yp
yp
yp
yp
yp
yp
jO
Gs
bJ
Ce
"}
(24,1,2) = {"
Ce
yp
yp
yp
yp
yp
yp
yp
yp
yp
yp
yp
yp
yp
HQ
yp
yp
yp
yp
yp
yp
yp
yp
yp
yp
TI
TI
TI
WU
Ce
"}
(25,1,2) = {"
Ce
yp
yp
yp
yp
yp
yp
yp
yp
yp
yp
yp
yp
HQ
HQ
HQ
yp
yp
yp
yp
yp
yp
yp
yp
TI
pO
qx
pO
TI
Ce
"}
(26,1,2) = {"
Ce
yp
yp
yp
yp
yp
yp
yp
yp
yp
yp
yp
yp
HQ
HQ
HQ
yp
yp
yp
fK
yp
yp
yp
jO
TI
zW
nJ
pO
TI
Ce
"}
(27,1,2) = {"
Ce
Ce
yp
yp
yp
yp
yp
yp
yp
yp
yp
yp
yp
HQ
HQ
yp
yp
yp
yp
yp
yp
yp
jO
jO
TI
pO
qe
pO
Ce
Ce
"}
(28,1,2) = {"
Ce
Ce
Ce
yp
yp
yp
yp
yp
yp
mE
mE
jO
mE
mE
jO
jO
jO
mE
mE
Ce
Ce
Ce
it
Hs
TI
TI
TI
TI
Ce
Ce
"}
(29,1,2) = {"
Ce
Ce
Ce
Ce
yp
yp
yp
yp
mE
mE
mE
jO
jO
mE
mE
jO
mE
mE
Ce
Ce
Ce
Ce
Ce
Ce
Ce
Ce
Ce
Ce
Ce
Ce
"}
(30,1,2) = {"
Ce
Ce
Ce
Ce
Ce
Ce
Ce
Ce
Ce
Ce
Ce
mE
jO
jO
jO
jO
mE
Ce
Ce
Ce
Ce
Ce
Ce
Ce
Ce
Ce
Ce
Ce
Ce
Ce
"}
