//MAP CONVERTED BY dmm2tgm.py THIS HEADER COMMENT PREVENTS RECONVERSION, DO NOT REMOVE
"aj" = (
/obj/structure/fluff/railing/border{
	dir = 6
	},
/obj/item/reagent_containers/food/snacks/smallrat,
/turf/open/floor/wood,
/area/rogue/under/tomb/indoors/church)
"bP" = (
/obj/structure/fluff/railing/border{
	dir = 4
	},
/turf/open/floor/wood,
/area/rogue/under/tomb/indoors/church)
"dn" = (
/obj/structure/door/weak/bolt{
	dir = 1
	},
/obj/effect/mapping_helpers/door/locker,
/turf/open/floor/hexstone{
	dir = 1
	},
/area/rogue/under/tomb/indoors/church)
"fb" = (
/turf/open/floor/hexstone,
/area/rogue/under/tomb/indoors/church)
"fq" = (
/obj/structure/table/church,
/obj/item/reagent_containers/glass/cup/golden{
	pixel_x = -6;
	pixel_y = 14
	},
/obj/item/gem/blue{
	pixel_y = 7;
	pixel_x = 5
	},
/turf/open/floor/hexstone,
/area/rogue/under/tomb/indoors/church)
"fQ" = (
/obj/structure/fluff/walldeco/painting/skull,
/turf/closed/wall/mineral/stone,
/area/rogue/under/tomb/indoors/church)
"fU" = (
/turf/open/floor/cobblerock,
/area/rogue/under/tomb)
"hd" = (
/obj/structure/fluff/railing/border{
	dir = 10
	},
/turf/open/floor/wood,
/area/rogue/under/tomb/indoors/church)
"jJ" = (
/obj/structure/chair/wood/alt/chair_noble/red,
/turf/open/floor/wood,
/area/rogue/under/tomb/indoors/church)
"kq" = (
/turf/open/floor/hexstone{
	dir = 1
	},
/area/rogue/under/tomb)
"kw" = (
/obj/structure/fluff/walldeco/painting/skull,
/turf/closed/wall/mineral/stone/moss,
/area/rogue/under/tomb/indoors/church)
"kZ" = (
/turf/open/transparent/openspace,
/area/rogue/under/tomb/indoors/church)
"lQ" = (
/obj/structure/fluff/railing/border{
	dir = 5
	},
/turf/open/floor/wood,
/area/rogue/under/tomb/indoors/church)
"mI" = (
/obj/machinery/light/fueled/chand,
/turf/open/transparent/openspace,
/area/rogue/under/tomb/indoors/church)
"mT" = (
/obj/structure/fluff/railing/border{
	dir = 1
	},
/obj/structure/table/wood/plain_alt,
/obj/item/reagent_containers/food/snacks/rotten/breadslice{
	pixel_x = 19
	},
/obj/item/weapon/knife/cleaver{
	pixel_x = -2;
	pixel_y = -8
	},
/turf/open/floor/wood,
/area/rogue/under/tomb/indoors/church)
"oj" = (
/obj/structure/chair/bench/church/mid,
/mob/living/carbon/human/species/skeleton/npc/warrior,
/turf/open/floor/carpet/lord/center,
/area/rogue/under/tomb/indoors/church)
"oB" = (
/obj/structure/chair/bench/church/r,
/turf/open/floor/carpet/lord/right,
/area/rogue/under/tomb/indoors/church)
"pr" = (
/turf/closed/mineral/bedrock,
/area/rogue/under/tomb)
"rN" = (
/obj/structure/fluff/walldeco/bigpainting,
/turf/open/transparent/openspace,
/area/rogue/under/tomb/indoors/church)
"rO" = (
/obj/structure/table/church/m,
/obj/item/clothing/ring/active/nomag{
	pixel_x = 23;
	pixel_y = 6
	},
/obj/item/weapon/sword/decorated{
	name = "A Lords Blade";
	desc = "A long dead kings Blade, Forgotten to time yet master in work."
	},
/turf/open/floor/hexstone,
/area/rogue/under/tomb/indoors/church)
"rS" = (
/obj/structure/fluff/railing/border{
	dir = 9
	},
/turf/open/floor/wood,
/area/rogue/under/tomb/indoors/church)
"sp" = (
/turf/open/floor/hexstone{
	dir = 1
	},
/area/rogue/under/tomb/indoors/church)
"sX" = (
/obj/structure/fluff/walldeco/bigpainting,
/turf/open/floor/hexstone,
/area/rogue/under/tomb/indoors/church)
"tm" = (
/obj/structure/chair/bench/church,
/turf/open/floor/carpet/lord/left,
/area/rogue/under/tomb/indoors/church)
"uY" = (
/obj/structure/fluff/railing/border{
	dir = 1
	},
/obj/structure/table/wood/plain_alt,
/obj/item/reagent_containers/glass/bottle/wine/sourwine,
/turf/open/floor/wood,
/area/rogue/under/tomb/indoors/church)
"vD" = (
/obj/structure/chair/bench/church/r,
/mob/living/carbon/human/species/skeleton/npc/warrior,
/turf/open/floor/carpet/lord/right,
/area/rogue/under/tomb/indoors/church)
"yg" = (
/obj/effect/dungeon_directional_helper/north,
/turf/open/floor/cobblerock,
/area/rogue/under/tomb)
"ys" = (
/obj/structure/door/weak/bolt{
	dir = 8
	},
/obj/effect/mapping_helpers/door/locker,
/turf/open/floor/hexstone,
/area/rogue/under/tomb/indoors/church)
"zj" = (
/obj/item/reagent_containers/food/snacks/smallrat,
/turf/open/floor/wood,
/area/rogue/under/tomb/indoors/church)
"AT" = (
/turf/open/floor/wood,
/area/rogue/under/tomb/indoors/church)
"BH" = (
/obj/structure/fluff/railing/border{
	dir = 1
	},
/obj/structure/table/wood/plain_alt,
/obj/item/reagent_containers/food/snacks/rotten/breadslice{
	pixel_y = -2;
	pixel_x = -13
	},
/turf/open/floor/wood,
/area/rogue/under/tomb/indoors/church)
"DZ" = (
/obj/structure/fluff/walldeco/painting/castle,
/turf/closed/wall/mineral/stone,
/area/rogue/under/tomb/indoors/church)
"EO" = (
/obj/structure/chair/bench/church/mid,
/turf/open/floor/carpet/lord/center,
/area/rogue/under/tomb/indoors/church)
"Gd" = (
/obj/structure/mirror/fancy,
/turf/open/floor/hexstone,
/area/rogue/under/tomb/indoors/church)
"Gk" = (
/obj/structure/chair/bench/church,
/mob/living/carbon/human/species/skeleton/npc/warrior,
/turf/open/floor/carpet/lord/left,
/area/rogue/under/tomb/indoors/church)
"GQ" = (
/obj/structure/fluff/walldeco/painting/crown,
/turf/closed/wall/mineral/stone/moss,
/area/rogue/under/tomb/indoors/church)
"HJ" = (
/obj/structure/chair/bench/throne,
/obj/item/reagent_containers/glass/bottle/redwine{
	pixel_x = -19
	},
/obj/item/reagent_containers/glass/bottle/redwine{
	pixel_x = 16;
	pixel_y = -11
	},
/obj/item/reagent_containers/glass/bottle/redwine{
	pixel_y = -13;
	pixel_x = -9
	},
/mob/living/carbon/human/species/skeleton/npc/warrior/skilled{
	name = "Wine Drenched Skeleton"
	},
/turf/open/floor/hexstone,
/area/rogue/under/tomb/indoors/church)
"IK" = (
/obj/structure/fluff/railing/border{
	dir = 1
	},
/turf/open/floor/wood,
/area/rogue/under/tomb/indoors/church)
"Kq" = (
/obj/structure/door/weak/bolt{
	dir = 4
	},
/obj/effect/mapping_helpers/door/locker,
/turf/open/floor/hexstone,
/area/rogue/under/tomb/indoors/church)
"KL" = (
/obj/structure/door/weak/bolt,
/obj/effect/mapping_helpers/door/locker,
/turf/open/floor/hexstone,
/area/rogue/under/tomb/indoors/church)
"Lp" = (
/obj/structure/fluff/walldeco/painting,
/turf/closed/wall/mineral/stone/moss,
/area/rogue/under/tomb/indoors/church)
"Mc" = (
/obj/structure/door/weak/bolt{
	dir = 1
	},
/obj/effect/mapping_helpers/door/locker,
/turf/open/floor/hexstone,
/area/rogue/under/tomb/indoors/church)
"Ns" = (
/obj/structure/fluff/walldeco/bigpainting/lake,
/turf/open/transparent/openspace,
/area/rogue/under/tomb/indoors/church)
"Nx" = (
/obj/effect/dungeon_directional_helper/east,
/turf/open/floor/cobblerock,
/area/rogue/under/tomb)
"Pc" = (
/obj/structure/chair/wood/alt/chair_noble/red{
	dir = 8
	},
/turf/open/floor/wood,
/area/rogue/under/tomb/indoors/church)
"Pg" = (
/obj/structure/table/vtable,
/obj/item/statue/gold/loot{
	pixel_y = 11
	},
/turf/open/floor/hexstone,
/area/rogue/under/tomb/indoors/church)
"Ph" = (
/obj/structure/fluff/railing/border,
/turf/open/floor/wood,
/area/rogue/under/tomb/indoors/church)
"PB" = (
/obj/item/ingot/gold,
/obj/item/ingot/gold{
	pixel_x = 9;
	pixel_y = -4
	},
/obj/item/ingot/gold{
	pixel_y = 4;
	pixel_x = 5
	},
/turf/open/floor/hexstone,
/area/rogue/under/tomb/indoors/church)
"PH" = (
/turf/closed/wall/mineral/stone,
/area/rogue/under/tomb/indoors/church)
"Qi" = (
/turf/closed/wall/mineral/stone/moss,
/area/rogue/under/tomb/indoors/church)
"QY" = (
/obj/structure/table/church{
	dir = 1
	},
/turf/open/floor/hexstone,
/area/rogue/under/tomb/indoors/church)
"Sx" = (
/obj/structure/fluff/railing/border{
	dir = 8
	},
/turf/open/floor/wood,
/area/rogue/under/tomb/indoors/church)
"SD" = (
/obj/structure/table/vtable/v2,
/obj/item/statue/gold{
	pixel_y = 14
	},
/turf/open/floor/hexstone,
/area/rogue/under/tomb/indoors/church)
"Uu" = (
/obj/structure/closet/crate/crafted_closet/inn/chest,
/obj/item/clothing/shirt/robe/black,
/obj/item/clothing/shirt/robe/mage,
/turf/open/floor/wood,
/area/rogue/under/tomb/indoors/church)
"UA" = (
/obj/effect/dungeon_directional_helper/south,
/turf/open/floor/cobblerock,
/area/rogue/under/tomb)
"ZB" = (
/obj/structure/table/wood/plain_alt,
/turf/open/floor/wood,
/area/rogue/under/tomb/indoors/church)
"ZI" = (
/obj/effect/dungeon_directional_helper/west,
/turf/open/floor/cobblerock,
/area/rogue/under/tomb)

(1,1,1) = {"
pr
pr
pr
pr
pr
fU
fU
ZI
fU
pr
pr
pr
pr
pr
pr
"}
(2,1,1) = {"
pr
Qi
Qi
PH
PH
PH
Kq
Kq
Qi
PH
Qi
Qi
Qi
Qi
pr
"}
(3,1,1) = {"
pr
Qi
fb
fb
fb
fb
fb
fb
fb
fb
fb
fb
fb
Qi
pr
"}
(4,1,1) = {"
pr
PH
sX
fb
fb
tm
tm
tm
tm
Gk
tm
fb
fb
Qi
pr
"}
(5,1,1) = {"
pr
PH
Pg
fb
fb
oj
EO
EO
EO
EO
EO
fb
fb
Qi
pr
"}
(6,1,1) = {"
pr
PH
SD
fb
fb
oB
oB
vD
oB
oB
oB
fb
fb
PH
pr
"}
(7,1,1) = {"
fU
KL
fb
fb
fq
fb
fb
fb
fb
fb
fb
fb
fb
Qi
fU
"}
(8,1,1) = {"
yg
fQ
HJ
fb
rO
fb
fb
fb
fb
sp
fb
fb
fb
Mc
UA
"}
(9,1,1) = {"
fU
KL
fb
fb
QY
fb
fb
fb
fb
fb
fb
fb
fb
Qi
fU
"}
(10,1,1) = {"
pr
Qi
PB
fb
fb
tm
tm
tm
Gk
tm
tm
fb
fb
Qi
pr
"}
(11,1,1) = {"
pr
Qi
fb
fb
fb
oj
EO
EO
EO
EO
EO
fb
fb
PH
pr
"}
(12,1,1) = {"
pr
DZ
fb
fb
fb
oB
oB
vD
oB
oB
vD
fb
fb
Qi
pr
"}
(13,1,1) = {"
pr
Qi
Gd
fb
fb
fb
fb
fb
fb
fb
fb
fb
fb
Qi
pr
"}
(14,1,1) = {"
pr
Qi
Qi
PH
PH
Qi
ys
ys
Qi
Qi
Lp
PH
Qi
Qi
pr
"}
(15,1,1) = {"
pr
pr
pr
pr
pr
fU
fU
Nx
fU
pr
pr
pr
pr
pr
pr
"}

(1,1,2) = {"
pr
pr
pr
pr
pr
kq
kq
kq
kq
pr
pr
pr
pr
pr
pr
"}
(2,1,2) = {"
pr
Qi
Qi
Qi
Qi
Qi
Kq
Kq
Qi
Qi
Qi
GQ
Qi
Qi
pr
"}
(3,1,2) = {"
pr
Qi
kZ
kZ
kZ
AT
AT
AT
AT
AT
AT
jJ
ZB
Qi
pr
"}
(4,1,2) = {"
pr
Qi
Ns
kZ
kZ
AT
AT
AT
AT
AT
AT
AT
Pc
Qi
pr
"}
(5,1,2) = {"
pr
Qi
kZ
kZ
kZ
bP
bP
lQ
aj
bP
bP
lQ
AT
Qi
pr
"}
(6,1,2) = {"
pr
Qi
kZ
kZ
kZ
kZ
kZ
IK
Ph
kZ
kZ
IK
AT
Qi
pr
"}
(7,1,2) = {"
kq
KL
Sx
kZ
kZ
kZ
kZ
kZ
kZ
kZ
kZ
mT
AT
dn
kq
"}
(8,1,2) = {"
kq
Qi
AT
kZ
mI
kZ
mI
kZ
mI
kZ
kZ
uY
AT
Qi
kq
"}
(9,1,2) = {"
kq
KL
bP
kZ
kZ
kZ
kZ
kZ
kZ
kZ
kZ
BH
AT
dn
kq
"}
(10,1,2) = {"
pr
Qi
kZ
kZ
kZ
kZ
kZ
IK
Ph
kZ
kZ
IK
AT
Qi
pr
"}
(11,1,2) = {"
pr
Qi
rN
kZ
kZ
Sx
Sx
rS
hd
Sx
Sx
rS
AT
Qi
pr
"}
(12,1,2) = {"
pr
Qi
kZ
kZ
kZ
AT
AT
AT
zj
AT
AT
AT
AT
Qi
pr
"}
(13,1,2) = {"
pr
Qi
kZ
kZ
kZ
AT
AT
AT
AT
AT
Uu
Uu
Uu
Qi
pr
"}
(14,1,2) = {"
pr
Qi
Qi
Qi
Qi
Qi
ys
ys
Qi
Qi
kw
Qi
Qi
Qi
pr
"}
(15,1,2) = {"
pr
pr
pr
pr
pr
kq
kq
kq
kq
pr
pr
pr
pr
pr
pr
"}
