//MAP CONVERTED BY dmm2tgm.py THIS HEADER COMMENT PREVENTS RECONVERSION, DO NOT REMOVE
"bZ" = (
/obj/structure/fluff/walldeco/painting/skull,
/turf/closed/wall/mineral/stone/moss,
/area/rogue/under/tomb/indoors/church)
"eD" = (
/turf/closed/wall/mineral/stone,
/area/rogue/under/tomb/indoors/church)
"fs" = (
/turf/open/floor/hexstone{
	dir = 1
	},
/area/rogue/under/tomb)
"ft" = (
/obj/machinery/light/fueled/chand,
/turf/open/transparent/openspace,
/area/rogue/under/tomb/indoors/church)
"fR" = (
/obj/structure/fluff/railing/border{
	dir = 1
	},
/obj/structure/table/wood/plain_alt,
/obj/item/reagent_containers/food/snacks/rotten/breadslice{
	pixel_y = -2;
	pixel_x = -13
	},
/turf/open/floor/wood,
/area/rogue/under/tomb/indoors/church)
"gi" = (
/obj/structure/chair/bench/church/mid,
/turf/open/floor/carpet/lord/center,
/area/rogue/under/tomb/indoors/church)
"gQ" = (
/turf/closed/wall/mineral/stone/moss,
/area/rogue/under/tomb/indoors/church)
"hp" = (
/obj/structure/door/weak/bolt{
	dir = 8
	},
/obj/effect/mapping_helpers/access/locker,
/turf/open/floor/hexstone,
/area/rogue/under/tomb/indoors/church)
"ik" = (
/obj/structure/door/weak/bolt{
	dir = 1
	},
/obj/effect/mapping_helpers/access/locker,
/turf/open/floor/hexstone{
	dir = 1
	},
/area/rogue/under/tomb/indoors/church)
"iu" = (
/obj/structure/chair/bench/church,
/mob/living/carbon/human/species/skeleton/npc/warrior,
/turf/open/floor/carpet/lord/left,
/area/rogue/under/tomb/indoors/church)
"kd" = (
/obj/structure/chair/bench/church/r,
/mob/living/carbon/human/species/skeleton/npc/warrior,
/turf/open/floor/carpet/lord/right,
/area/rogue/under/tomb/indoors/church)
"kp" = (
/obj/structure/chair/bench/throne,
/obj/item/reagent_containers/glass/bottle/redwine{
	pixel_x = -19
	},
/obj/item/reagent_containers/glass/bottle/redwine{
	pixel_x = 16;
	pixel_y = -11
	},
/obj/item/reagent_containers/glass/bottle/redwine{
	pixel_y = -13;
	pixel_x = -9
	},
/mob/living/carbon/human/species/skeleton/npc/warrior/skilled{
	name = "Wine Drenched Skeleton"
	},
/turf/open/floor/hexstone,
/area/rogue/under/tomb/indoors/church)
"lM" = (
/obj/structure/table/church/m,
/obj/item/clothing/ring/active/nomag{
	pixel_x = 23;
	pixel_y = 6
	},
/obj/item/weapon/sword/decorated{
	name = "A Lords Blade";
	desc = "A long dead kings Blade, Forgotten to time yet master in work."
	},
/turf/open/floor/hexstone,
/area/rogue/under/tomb/indoors/church)
"ml" = (
/obj/structure/fluff/railing/border{
	dir = 10
	},
/turf/open/floor/wood,
/area/rogue/under/tomb/indoors/church)
"mW" = (
/obj/structure/chair/wood/alt/chair_noble/red,
/turf/open/floor/wood,
/area/rogue/under/tomb/indoors/church)
"pn" = (
/obj/structure/fluff/walldeco/painting,
/turf/closed/wall/mineral/stone/moss,
/area/rogue/under/tomb/indoors/church)
"pt" = (
/obj/structure/fluff/railing/border{
	dir = 1
	},
/turf/open/floor/wood,
/area/rogue/under/tomb/indoors/church)
"qA" = (
/obj/structure/fluff/railing/border{
	dir = 8
	},
/turf/open/floor/wood,
/area/rogue/under/tomb/indoors/church)
"rq" = (
/turf/open/floor/hexstone,
/area/rogue/under/tomb/indoors/church)
"rG" = (
/obj/effect/dungeon_directional_helper/north,
/turf/open/floor/cobblerock,
/area/rogue/under/tomb)
"sj" = (
/obj/structure/table/church{
	dir = 1
	},
/turf/open/floor/hexstone,
/area/rogue/under/tomb/indoors/church)
"sk" = (
/obj/structure/fluff/railing/border{
	dir = 6
	},
/obj/item/reagent_containers/food/snacks/smallrat,
/turf/open/floor/wood,
/area/rogue/under/tomb/indoors/church)
"sU" = (
/obj/structure/table/vtable,
/obj/item/statue/gold/loot{
	pixel_y = 11
	},
/turf/open/floor/hexstone,
/area/rogue/under/tomb/indoors/church)
"tN" = (
/obj/structure/fluff/walldeco/bigpainting,
/turf/open/floor/hexstone,
/area/rogue/under/tomb/indoors/church)
"uk" = (
/obj/structure/chair/bench/church,
/turf/open/floor/carpet/lord/left,
/area/rogue/under/tomb/indoors/church)
"uN" = (
/obj/structure/fluff/walldeco/painting/skull,
/turf/closed/wall/mineral/stone,
/area/rogue/under/tomb/indoors/church)
"ve" = (
/obj/effect/dungeon_directional_helper/south,
/turf/open/floor/cobblerock,
/area/rogue/under/tomb)
"wm" = (
/obj/item/ingot/gold,
/obj/item/ingot/gold{
	pixel_x = 9;
	pixel_y = -4
	},
/obj/item/ingot/gold{
	pixel_y = 4;
	pixel_x = 5
	},
/turf/open/floor/hexstone,
/area/rogue/under/tomb/indoors/church)
"Dn" = (
/obj/structure/fluff/walldeco/painting/crown,
/turf/closed/wall/mineral/stone/moss,
/area/rogue/under/tomb/indoors/church)
"FJ" = (
/obj/item/reagent_containers/food/snacks/smallrat,
/turf/open/floor/wood,
/area/rogue/under/tomb/indoors/church)
"Gd" = (
/turf/open/transparent/openspace,
/area/rogue/under/tomb/indoors/church)
"Gu" = (
/obj/effect/dungeon_directional_helper/east,
/turf/open/floor/cobblerock,
/area/rogue/under/tomb)
"HA" = (
/turf/closed/mineral/bedrock,
/area/rogue/under/tomb)
"IO" = (
/turf/open/floor/hexstone{
	dir = 1
	},
/area/rogue/under/tomb/indoors/church)
"Jj" = (
/obj/effect/dungeon_directional_helper/west,
/turf/open/floor/cobblerock,
/area/rogue/under/tomb)
"Jr" = (
/obj/structure/table/vtable/v2,
/obj/item/statue/gold{
	pixel_y = 14
	},
/turf/open/floor/hexstone,
/area/rogue/under/tomb/indoors/church)
"KA" = (
/obj/structure/chair/bench/church/mid,
/mob/living/carbon/human/species/skeleton/npc/warrior,
/turf/open/floor/carpet/lord/center,
/area/rogue/under/tomb/indoors/church)
"KI" = (
/obj/structure/fluff/walldeco/bigpainting/lake,
/turf/open/transparent/openspace,
/area/rogue/under/tomb/indoors/church)
"KQ" = (
/obj/structure/table/church,
/obj/item/reagent_containers/glass/cup/golden{
	pixel_x = -6;
	pixel_y = 14
	},
/obj/item/gem/blue{
	pixel_y = 7;
	pixel_x = 5
	},
/turf/open/floor/hexstone,
/area/rogue/under/tomb/indoors/church)
"Ly" = (
/obj/structure/table/wood/plain_alt,
/turf/open/floor/wood,
/area/rogue/under/tomb/indoors/church)
"LO" = (
/obj/structure/fluff/railing/border{
	dir = 1
	},
/obj/structure/table/wood/plain_alt,
/obj/item/reagent_containers/glass/bottle/wine/sourwine,
/turf/open/floor/wood,
/area/rogue/under/tomb/indoors/church)
"Mw" = (
/obj/structure/door/weak/bolt,
/obj/effect/mapping_helpers/access/locker,
/turf/open/floor/hexstone,
/area/rogue/under/tomb/indoors/church)
"Ng" = (
/obj/structure/door/weak/bolt{
	dir = 1
	},
/obj/effect/mapping_helpers/access/locker,
/turf/open/floor/hexstone,
/area/rogue/under/tomb/indoors/church)
"Nu" = (
/obj/structure/fluff/railing/border{
	dir = 9
	},
/turf/open/floor/wood,
/area/rogue/under/tomb/indoors/church)
"Qo" = (
/obj/structure/fluff/railing/border{
	dir = 4
	},
/turf/open/floor/wood,
/area/rogue/under/tomb/indoors/church)
"St" = (
/obj/structure/door/weak/bolt{
	dir = 4
	},
/obj/effect/mapping_helpers/access/locker,
/turf/open/floor/hexstone,
/area/rogue/under/tomb/indoors/church)
"SB" = (
/obj/structure/fluff/walldeco/painting/castle,
/turf/closed/wall/mineral/stone,
/area/rogue/under/tomb/indoors/church)
"SO" = (
/turf/open/floor/cobblerock,
/area/rogue/under/tomb)
"SQ" = (
/turf/open/floor/wood,
/area/rogue/under/tomb/indoors/church)
"TH" = (
/obj/structure/closet/crate/crafted_closet/inn/chest,
/obj/item/clothing/shirt/robe/colored/black,
/obj/item/clothing/shirt/robe/colored/mage,
/turf/open/floor/wood,
/area/rogue/under/tomb/indoors/church)
"TP" = (
/obj/structure/chair/bench/church/r,
/turf/open/floor/carpet/lord/right,
/area/rogue/under/tomb/indoors/church)
"Uj" = (
/obj/structure/fluff/walldeco/bigpainting,
/turf/open/transparent/openspace,
/area/rogue/under/tomb/indoors/church)
"VW" = (
/obj/structure/chair/wood/alt/chair_noble/red{
	dir = 8
	},
/turf/open/floor/wood,
/area/rogue/under/tomb/indoors/church)
"Wd" = (
/obj/structure/fluff/railing/border{
	dir = 5
	},
/turf/open/floor/wood,
/area/rogue/under/tomb/indoors/church)
"WQ" = (
/obj/structure/mirror/fancy,
/turf/open/floor/hexstone,
/area/rogue/under/tomb/indoors/church)
"WW" = (
/obj/structure/fluff/railing/border,
/turf/open/floor/wood,
/area/rogue/under/tomb/indoors/church)
"Yh" = (
/obj/structure/fluff/railing/border{
	dir = 1
	},
/obj/structure/table/wood/plain_alt,
/obj/item/reagent_containers/food/snacks/rotten/breadslice{
	pixel_x = 19
	},
/obj/item/weapon/knife/cleaver{
	pixel_x = -2;
	pixel_y = -8
	},
/turf/open/floor/wood,
/area/rogue/under/tomb/indoors/church)

(1,1,1) = {"
HA
HA
HA
HA
HA
SO
SO
Jj
SO
HA
HA
HA
HA
HA
HA
"}
(2,1,1) = {"
HA
gQ
gQ
eD
eD
eD
St
St
gQ
eD
gQ
gQ
gQ
gQ
HA
"}
(3,1,1) = {"
HA
gQ
rq
rq
rq
rq
rq
rq
rq
rq
rq
rq
rq
gQ
HA
"}
(4,1,1) = {"
HA
eD
tN
rq
rq
uk
uk
uk
uk
iu
uk
rq
rq
gQ
HA
"}
(5,1,1) = {"
HA
eD
sU
rq
rq
KA
gi
gi
gi
gi
gi
rq
rq
gQ
HA
"}
(6,1,1) = {"
HA
eD
Jr
rq
rq
TP
TP
kd
TP
TP
TP
rq
rq
eD
HA
"}
(7,1,1) = {"
SO
Mw
rq
rq
KQ
rq
rq
rq
rq
rq
rq
rq
rq
gQ
SO
"}
(8,1,1) = {"
rG
uN
kp
rq
lM
rq
rq
rq
rq
IO
rq
rq
rq
Ng
ve
"}
(9,1,1) = {"
SO
Mw
rq
rq
sj
rq
rq
rq
rq
rq
rq
rq
rq
gQ
SO
"}
(10,1,1) = {"
HA
gQ
wm
rq
rq
uk
uk
uk
iu
uk
uk
rq
rq
gQ
HA
"}
(11,1,1) = {"
HA
gQ
rq
rq
rq
KA
gi
gi
gi
gi
gi
rq
rq
eD
HA
"}
(12,1,1) = {"
HA
SB
rq
rq
rq
TP
TP
kd
TP
TP
kd
rq
rq
gQ
HA
"}
(13,1,1) = {"
HA
gQ
WQ
rq
rq
rq
rq
rq
rq
rq
rq
rq
rq
gQ
HA
"}
(14,1,1) = {"
HA
gQ
gQ
eD
eD
gQ
hp
hp
gQ
gQ
pn
eD
gQ
gQ
HA
"}
(15,1,1) = {"
HA
HA
HA
HA
HA
SO
SO
Gu
SO
HA
HA
HA
HA
HA
HA
"}

(1,1,2) = {"
HA
HA
HA
HA
HA
fs
fs
fs
fs
HA
HA
HA
HA
HA
HA
"}
(2,1,2) = {"
HA
gQ
gQ
gQ
gQ
gQ
St
St
gQ
gQ
gQ
Dn
gQ
gQ
HA
"}
(3,1,2) = {"
HA
gQ
Gd
Gd
Gd
SQ
SQ
SQ
SQ
SQ
SQ
mW
Ly
gQ
HA
"}
(4,1,2) = {"
HA
gQ
KI
Gd
Gd
SQ
SQ
SQ
SQ
SQ
SQ
SQ
VW
gQ
HA
"}
(5,1,2) = {"
HA
gQ
Gd
Gd
Gd
Qo
Qo
Wd
sk
Qo
Qo
Wd
SQ
gQ
HA
"}
(6,1,2) = {"
HA
gQ
Gd
Gd
Gd
Gd
Gd
pt
WW
Gd
Gd
pt
SQ
gQ
HA
"}
(7,1,2) = {"
fs
Mw
qA
Gd
Gd
Gd
Gd
Gd
Gd
Gd
Gd
Yh
SQ
ik
fs
"}
(8,1,2) = {"
fs
gQ
SQ
Gd
ft
Gd
ft
Gd
ft
Gd
Gd
LO
SQ
gQ
fs
"}
(9,1,2) = {"
fs
Mw
Qo
Gd
Gd
Gd
Gd
Gd
Gd
Gd
Gd
fR
SQ
ik
fs
"}
(10,1,2) = {"
HA
gQ
Gd
Gd
Gd
Gd
Gd
pt
WW
Gd
Gd
pt
SQ
gQ
HA
"}
(11,1,2) = {"
HA
gQ
Uj
Gd
Gd
qA
qA
Nu
ml
qA
qA
Nu
SQ
gQ
HA
"}
(12,1,2) = {"
HA
gQ
Gd
Gd
Gd
SQ
SQ
SQ
FJ
SQ
SQ
SQ
SQ
gQ
HA
"}
(13,1,2) = {"
HA
gQ
Gd
Gd
Gd
SQ
SQ
SQ
SQ
SQ
TH
TH
TH
gQ
HA
"}
(14,1,2) = {"
HA
gQ
gQ
gQ
gQ
gQ
hp
hp
gQ
gQ
bZ
gQ
gQ
gQ
HA
"}
(15,1,2) = {"
HA
HA
HA
HA
HA
fs
fs
fs
fs
HA
HA
HA
HA
HA
HA
"}
