//MAP CONVERTED BY dmm2tgm.py THIS HEADER COMMENT PREVENTS RECONVERSION, DO NOT REMOVE
"aF" = (
/obj/structure/closet/crate/chest/neu_fancy{
	locked = 1
	},
/obj/item/weapon/knife/dagger/silver,
/obj/item/reagent_containers/powder/moondust_purest,
/obj/item/reagent_containers/powder/moondust_purest{
	pixel_y = -4;
	pixel_x = -3
	},
/obj/item/reagent_containers/powder/moondust_purest{
	pixel_x = 6
	},
/obj/item/reagent_containers/powder/ozium{
	pixel_y = -8;
	pixel_x = -1
	},
/turf/open/floor/ruinedwood/turned/darker,
/area/rogue/under/cave)
"bf" = (
/obj/structure/fluff/walldeco/vinez/r,
/turf/open/floor/blocks,
/area/rogue/under/cave)
"ch" = (
/obj/structure/stairs/d{
	dir = 4
	},
/turf/closed,
/area/rogue/under/cave)
"ck" = (
/obj/structure/table/wood/counter,
/obj/structure/bars/alt,
/obj/item/candle/yellow/lit,
/turf/open/floor/cobblerock,
/area/rogue/under/cave)
"cn" = (
/obj/item/alch/golddust,
/obj/structure/closet/crate/chest/neu_fancy{
	locked = 1
	},
/obj/item/reagent_containers/powder/blastpowder,
/obj/item/reagent_containers/powder/blastpowder,
/obj/item/reagent_containers/powder/blastpowder,
/turf/open/floor/ruinedwood/turned/darker,
/area/rogue/under/cave)
"cz" = (
/obj/structure/mineral_door/swing_door,
/turf/open/floor/cobblerock,
/area/rogue/under/cave)
"cD" = (
/obj/structure/kneestingers{
	pixel_y = 12
	},
/turf/open/floor/cobblerock,
/area/rogue/under/cave)
"dt" = (
/obj/structure/table/wood/counter{
	dir = 1
	},
/obj/item/reagent_containers/food/snacks/rotten/breadslice,
/turf/open/floor/dirt,
/area/rogue/under/cave)
"gY" = (
/obj/structure/closet/crate/drawer/inn,
/turf/open/floor/ruinedwood/turned/darker,
/area/rogue/under/cave)
"ix" = (
/obj/structure/closet/crate/chest/wicker,
/obj/item/reagent_containers/food/snacks/produce/wheat,
/obj/item/reagent_containers/food/snacks/produce/wheat,
/obj/item/reagent_containers/food/snacks/produce/wheat,
/obj/item/reagent_containers/food/snacks/produce/wheat,
/obj/item/reagent_containers/food/snacks/produce/wheat,
/obj/item/reagent_containers/food/snacks/raisins,
/obj/item/reagent_containers/food/snacks/raisins,
/obj/item/reagent_containers/food/snacks/raisins,
/obj/item/reagent_containers/food/snacks/raisins,
/obj/item/reagent_containers/food/snacks/raisins,
/turf/open/floor/ruinedwood/turned/darker,
/area/rogue/under/cave)
"iX" = (
/turf/closed/mineral/bedrock,
/area/rogue/under/cave)
"jS" = (
/obj/structure/ladder,
/turf/open/floor/ruinedwood/turned/darker,
/area/rogue/under/cave)
"kz" = (
/obj/structure/stairs{
	dir = 4
	},
/turf/open/floor/ruinedwood/turned/darker,
/area/rogue/under/cave)
"kH" = (
/obj/structure/table/wood/counter{
	dir = 1
	},
/obj/item/reagent_containers/food/snacks/rotten/breadslice,
/turf/open/floor/ruinedwood/turned/darker,
/area/rogue/under/cave)
"mG" = (
/obj/machinery/light/fueled/campfire/longlived,
/turf/open/floor/ruinedwood/turned/darker,
/area/rogue/under/cave)
"mH" = (
/turf/open/floor/cobblerock,
/area/rogue/under/cave)
"np" = (
/obj/structure/table/wood/plain_alt,
/obj/structure/fluff/millstone,
/obj/item/weapon/knife/cleaver{
	pixel_y = 7;
	pixel_x = -2
	},
/turf/open/floor/ruinedwood/turned/darker,
/area/rogue/under/cave)
"nw" = (
/turf/open/floor/ruinedwood/turned/darker,
/area/rogue/under/cave)
"nZ" = (
/obj/structure/fluff/walldeco/vinez,
/turf/closed/wall/mineral/stone/moss,
/area/rogue/under/cave)
"oo" = (
/turf/open/transparent/openspace,
/area/rogue/under/cave)
"oP" = (
/obj/structure/fluff/walldeco/vinez/offset,
/turf/open/floor/cobblerock,
/area/rogue/under/cave)
"pQ" = (
/mob/living/carbon/human/species/skeleton/npc/peasant,
/turf/open/floor/dirt,
/area/rogue/under/cave)
"qO" = (
/obj/structure/closet/crate/chest/wicker,
/obj/item/alch/bonemeal,
/obj/item/alch/bonemeal,
/obj/item/alch/bonemeal,
/turf/open/floor/ruinedwood/turned/darker,
/area/rogue/under/cave)
"ri" = (
/obj/structure/closet/crate/drawer/inn,
/obj/item/clothing/face/cigarette/pipe/westman,
/obj/item/clothing/face/cigarette/rollie/trippy,
/obj/item/clothing/face/cigarette/rollie/trippy,
/obj/item/clothing/face/cigarette/rollie/trippy{
	pixel_y = 8
	},
/obj/item/clothing/face/cigarette/rollie/trippy{
	pixel_y = 14;
	pixel_x = -7
	},
/obj/item/clothing/face/spectacles/golden,
/turf/open/floor/ruinedwood/turned/darker,
/area/rogue/under/cave)
"rH" = (
/obj/effect/dungeon_directional_helper/south,
/turf/open/floor/cobblerock,
/area/rogue/under/cave)
"rT" = (
/obj/structure/stairs{
	dir = 1
	},
/turf/open/floor/ruinedwood/turned/darker,
/area/rogue/under/cave)
"rY" = (
/obj/item/candle/yellow/lit{
	pixel_y = 10;
	pixel_x = -10
	},
/obj/item/organ/eyes/night_vision/werewolf,
/obj/item/organ/eyes/night_vision/werewolf{
	pixel_y = -6;
	pixel_x = -12
	},
/obj/structure/table/wood/plain_alt,
/obj/item/storage/backpack/satchel/surgbag{
	pixel_x = 7
	},
/turf/open/floor/ruinedwood/turned/darker,
/area/rogue/under/cave)
"tj" = (
/obj/structure/closet/crate/chest/wicker,
/obj/item/reagent_containers/food/snacks/produce/wheat,
/obj/item/reagent_containers/food/snacks/produce/wheat,
/obj/item/reagent_containers/food/snacks/produce/wheat,
/obj/item/reagent_containers/food/snacks/produce/wheat,
/turf/open/floor/ruinedwood/turned/darker,
/area/rogue/under/cave)
"tm" = (
/obj/structure/kneestingers{
	pixel_y = 12
	},
/turf/open/floor/plank/h,
/area/rogue/under/cave)
"to" = (
/obj/structure/table/wood/counter/end{
	dir = 8
	},
/obj/structure/bars/alt,
/turf/open/floor/cobblerock,
/area/rogue/under/cave)
"un" = (
/obj/structure/closet/crate/chest{
	locked = 1
	},
/obj/item/reagent_containers/glass/bottle/healthpot,
/obj/item/reagent_containers/glass/bottle/healthpot,
/obj/item/reagent_containers/glass/bottle/healthpot{
	pixel_x = -8
	},
/turf/open/floor/ruinedwood/turned/darker,
/area/rogue/under/cave)
"uC" = (
/obj/structure/bed/shit,
/turf/open/floor/ruinedwood/turned/darker,
/area/rogue/under/cave)
"uK" = (
/obj/effect/dungeon_directional_helper/east,
/turf/open/floor/cobblerock,
/area/rogue/under/cave)
"wk" = (
/mob/living/carbon/human/species/skeleton/npc/ambush,
/turf/open/floor/ruinedwood/turned/darker,
/area/rogue/under/cave)
"wp" = (
/obj/structure/kneestingers{
	pixel_y = 12
	},
/turf/open/floor/dirt,
/area/rogue/under/cave)
"xq" = (
/obj/structure/closet/crate/crafted_closet/inn/south,
/obj/item/clothing/cloak/wickercloak,
/obj/item/clothing/gloves/fingerless,
/obj/item/clothing/head/antlerhood,
/obj/item/clothing/face/skullmask,
/turf/open/floor/ruinedwood/turned/darker,
/area/rogue/under/cave)
"yt" = (
/obj/structure/stairs/d{
	dir = 1
	},
/turf/open/floor/ruinedwood/turned/darker,
/area/rogue/under/cave)
"yv" = (
/obj/structure/bars,
/turf/open/floor/ruinedwood/turned/darker,
/area/rogue/under/cave)
"yE" = (
/obj/structure/table/wood/counter,
/obj/structure/bars/alt,
/turf/open/floor/cobblerock,
/area/rogue/under/cave)
"zG" = (
/obj/effect/landmark/chest_or_mimic,
/obj/item/reagent_containers/glass/bottle/stronghealthpot,
/turf/open/floor/ruinedwood/turned/darker,
/area/rogue/under/cave)
"Am" = (
/turf/open/floor/blocks,
/area/rogue/under/cave)
"Bv" = (
/obj/structure/kneestingers{
	pixel_y = 12
	},
/turf/open/floor/ruinedwood/turned/darker,
/area/rogue/under/cave)
"BM" = (
/obj/structure/closet/crate/chest/wicker,
/obj/item/alch/golddust,
/obj/item/alch/silverdust,
/obj/item/alch/irondust,
/turf/open/floor/ruinedwood/turned/darker,
/area/rogue/under/cave)
"BP" = (
/obj/structure/fluff/walldeco/vinez/r,
/turf/open/floor/ruinedwood/turned/darker,
/area/rogue/under/cave)
"CD" = (
/obj/structure/kneestingers,
/turf/open/floor/ruinedwood/turned/darker,
/area/rogue/under/cave)
"CE" = (
/obj/structure/table/optable,
/obj/structure/fluff/walldeco/chains{
	pixel_y = 21;
	pixel_x = 9
	},
/turf/open/floor/ruinedwood/turned/darker,
/area/rogue/under/cave)
"EJ" = (
/obj/structure/bed/inn/double,
/obj/item/bedsheet/fabric_double,
/turf/open/floor/ruinedwood/turned/darker,
/area/rogue/under/cave)
"EK" = (
/obj/structure/closet/crate/chest/wicker,
/obj/item/reagent_containers/food/snacks/produce/wheat,
/obj/item/reagent_containers/food/snacks/produce/wheat,
/obj/item/reagent_containers/food/snacks/produce/wheat,
/obj/item/reagent_containers/food/snacks/produce/wheat,
/obj/item/reagent_containers/food/snacks/produce/wheat,
/obj/item/reagent_containers/food/snacks/raisins,
/obj/item/reagent_containers/food/snacks/raisins,
/obj/item/reagent_containers/food/snacks/raisins,
/obj/item/reagent_containers/food/snacks/raisins,
/obj/item/reagent_containers/food/snacks/raisins,
/obj/item/reagent_containers/food/snacks/raisins,
/turf/open/floor/ruinedwood/turned/darker,
/area/rogue/under/cave)
"EU" = (
/obj/structure/kneestingers{
	pixel_y = 11
	},
/turf/open/floor/plank/h,
/area/rogue/under/cave)
"FJ" = (
/obj/structure/table/wood/counter/end,
/obj/item/reagent_containers/food/snacks/rotten/breadslice,
/obj/item/reagent_containers/food/snacks/rotten/breadslice{
	pixel_y = 3;
	pixel_x = 2
	},
/obj/item/reagent_containers/food/snacks/rotten/breadslice{
	pixel_y = 7;
	pixel_x = 3
	},
/turf/open/floor/dirt,
/area/rogue/under/cave)
"Ga" = (
/obj/structure/closet/crate/chest,
/obj/item/reagent_containers/food/snacks/cooked/coppiette,
/turf/open/floor/ruinedwood/turned/darker,
/area/rogue/under/cave)
"Hv" = (
/turf/open/floor/plank/h,
/area/rogue/under/cave)
"Jl" = (
/obj/structure/closet/crate/chest/wicker,
/obj/item/reagent_containers/food/snacks/produce/wheat,
/obj/item/reagent_containers/food/snacks/produce/wheat,
/obj/item/reagent_containers/food/snacks/produce/wheat,
/obj/item/reagent_containers/food/snacks/produce/wheat,
/obj/item/reagent_containers/food/snacks/produce/wheat,
/obj/item/reagent_containers/food/snacks/produce/wheat,
/turf/open/floor/ruinedwood/turned/darker,
/area/rogue/under/cave)
"Ld" = (
/obj/item/reagent_containers/glass/bucket/wooden,
/turf/open/floor/cobblerock,
/area/rogue/under/cave)
"MK" = (
/obj/structure/mineral_door/bars{
	locked = 1
	},
/turf/open/floor/ruinedwood/turned/darker,
/area/rogue/under/cave)
"Qb" = (
/obj/structure/closet/crate/chest/wicker,
/obj/item/reagent_containers/food/snacks/produce/wheat,
/obj/item/reagent_containers/food/snacks/produce/wheat,
/obj/item/reagent_containers/food/snacks/produce/wheat,
/obj/item/reagent_containers/food/snacks/produce/wheat,
/obj/item/reagent_containers/food/snacks/produce/wheat,
/obj/item/reagent_containers/food/snacks/produce/wheat,
/obj/item/reagent_containers/food/snacks/produce/wheat,
/turf/open/floor/ruinedwood/turned/darker,
/area/rogue/under/cave)
"Qu" = (
/obj/effect/dungeon_directional_helper/west,
/turf/open/floor/cobblerock,
/area/rogue/under/cave)
"QB" = (
/turf/closed/wall/mineral/stone,
/area/rogue/under/cave)
"SO" = (
/obj/structure/closet/crate/chest/wicker,
/obj/item/alch/horn,
/turf/open/floor/ruinedwood/turned/darker,
/area/rogue/under/cave)
"Tj" = (
/turf/closed/wall/mineral/stone/moss,
/area/rogue/under/cave)
"Ty" = (
/turf/open/floor/dirt,
/area/rogue/under/cave)
"Ub" = (
/obj/structure/well,
/turf/open/floor/cobblerock,
/area/rogue/under/cave)
"UC" = (
/obj/structure/fluff/walldeco/vinez,
/turf/open/floor/dirt,
/area/rogue/under/cave)
"Vl" = (
/obj/structure/fluff/walldeco/vinez/r,
/turf/open/floor/cobblerock,
/area/rogue/under/cave)
"Wj" = (
/obj/effect/dungeon_directional_helper/north,
/turf/open/floor/cobblerock,
/area/rogue/under/cave)
"Wq" = (
/obj/effect/decal/remains/human,
/obj/structure/fluff/walldeco/vinez/l,
/turf/open/floor/ruinedwood/turned/darker,
/area/rogue/under/cave)
"Xu" = (
/obj/structure/closet/crate/chest/wicker,
/obj/item/alch/magicdust,
/obj/item/alch/magicdust,
/turf/open/floor/ruinedwood/turned/darker,
/area/rogue/under/cave)
"Zr" = (
/obj/structure/bed/hay,
/turf/open/floor/ruinedwood/turned/darker,
/area/rogue/under/cave)
"ZJ" = (
/obj/structure/mineral_door/wood/violet{
	locked = 1
	},
/turf/open/floor/cobblerock,
/area/rogue/under/cave)
"ZL" = (
/obj/item/clothing/head/hatblu,
/mob/living/carbon/human/species/zizombie/ambush,
/turf/open/floor/ruinedwood/turned/darker,
/area/rogue/under/cave)
"ZT" = (
/obj/machinery/light/fueled/oven/west,
/obj/machinery/light/fueled/oven/south,
/turf/open/floor/ruinedwood/turned/darker,
/area/rogue/under/cave)

(1,1,1) = {"
iX
iX
iX
iX
iX
iX
iX
iX
iX
mH
Qu
iX
iX
iX
iX
iX
iX
iX
iX
iX
"}
(2,1,1) = {"
iX
mH
mH
mH
mH
mH
mH
mH
mH
mH
mH
Ty
Ty
Ty
Ty
Ty
Ty
Ty
Ty
iX
"}
(3,1,1) = {"
iX
mH
mH
mH
mH
mH
mH
mH
mH
mH
mH
Ty
Ty
Ty
Ty
Ty
Ty
Ty
Ty
iX
"}
(4,1,1) = {"
iX
mH
mH
Tj
Tj
Ty
Ty
Tj
Tj
mH
mH
Tj
Tj
QB
QB
Tj
Tj
Ty
Ty
iX
"}
(5,1,1) = {"
iX
mH
mH
Tj
gY
nw
nw
nw
Tj
oP
mH
QB
CE
Wq
nw
jS
Tj
Ty
Ty
iX
"}
(6,1,1) = {"
iX
mH
mH
QB
Zr
Ty
Ty
nw
Ty
mH
mH
Tj
rY
nw
nw
un
QB
Ty
Ty
iX
"}
(7,1,1) = {"
iX
mH
mH
QB
nw
ZL
nw
nw
QB
oP
mH
Tj
nw
nw
nw
zG
QB
Ty
Ty
iX
"}
(8,1,1) = {"
iX
mH
mH
Tj
QB
Tj
rT
nw
Tj
oP
mH
Tj
nw
nw
BP
BP
Tj
Ty
Ty
iX
"}
(9,1,1) = {"
iX
mH
mH
Tj
QB
Tj
QB
Tj
mH
Vl
mH
QB
ck
yE
to
ZJ
Tj
Ty
Ty
iX
"}
(10,1,1) = {"
mH
mH
mH
mH
mH
mH
mH
mH
mH
Ub
mH
cz
Am
Am
Am
Am
QB
Ty
Ty
mH
"}
(11,1,1) = {"
Wj
mH
mH
mH
mH
mH
mH
mH
mH
Ld
mH
Tj
Ty
Am
bf
Am
Tj
Ty
Ty
rH
"}
(12,1,1) = {"
iX
mH
mH
Tj
QB
Tj
Tj
QB
Tj
mH
mH
Tj
Ty
Tj
QB
Tj
Tj
Ty
Ty
iX
"}
(13,1,1) = {"
iX
mH
mH
Tj
np
nw
nw
nw
Tj
mH
mH
mH
mH
mH
mH
mH
mH
mH
mH
iX
"}
(14,1,1) = {"
iX
mH
mH
Tj
nw
pQ
FJ
nw
UC
mH
mH
mH
mH
mH
cD
mH
mH
mH
mH
iX
"}
(15,1,1) = {"
iX
mH
mH
QB
kz
nw
dt
nw
nZ
mH
mH
mH
Tj
Tj
QB
QB
Tj
mH
mH
iX
"}
(16,1,1) = {"
iX
mH
mH
Tj
QB
ZT
kH
nw
UC
mH
mH
mH
cD
Ty
wp
Ga
Tj
mH
mH
iX
"}
(17,1,1) = {"
iX
mH
mH
Tj
Tj
QB
Tj
Tj
Tj
mH
mH
mH
Tj
Ty
jS
tj
QB
mH
mH
iX
"}
(18,1,1) = {"
iX
mH
mH
mH
mH
mH
mH
mH
mH
mH
mH
mH
Tj
Bv
nw
nw
QB
mH
mH
iX
"}
(19,1,1) = {"
iX
mH
mH
mH
mH
mH
mH
mH
mH
mH
mH
mH
Tj
Tj
Tj
Tj
Tj
mH
mH
iX
"}
(20,1,1) = {"
iX
iX
iX
iX
iX
iX
iX
iX
iX
mH
uK
mH
iX
iX
iX
iX
iX
iX
iX
iX
"}

(1,1,2) = {"
iX
iX
iX
iX
iX
iX
iX
iX
iX
oo
oo
iX
iX
iX
iX
iX
iX
iX
iX
iX
"}
(2,1,2) = {"
iX
oo
oo
oo
oo
oo
oo
oo
oo
oo
oo
oo
oo
oo
oo
oo
oo
oo
oo
iX
"}
(3,1,2) = {"
iX
oo
oo
oo
oo
oo
oo
oo
oo
oo
oo
oo
oo
oo
oo
oo
oo
oo
oo
iX
"}
(4,1,2) = {"
iX
oo
oo
Tj
Tj
oo
oo
Tj
Tj
oo
oo
QB
QB
QB
QB
QB
QB
oo
oo
iX
"}
(5,1,2) = {"
iX
oo
oo
Tj
uC
nw
uC
nw
Tj
oo
oo
QB
Xu
SO
yv
jS
QB
oo
oo
iX
"}
(6,1,2) = {"
iX
oo
oo
Tj
nw
nw
nw
nw
oo
oo
oo
QB
BM
wk
MK
nw
QB
oo
oo
iX
"}
(7,1,2) = {"
iX
oo
oo
Tj
nw
mG
nw
nw
Tj
oo
oo
QB
qO
cn
yv
nw
QB
oo
oo
iX
"}
(8,1,2) = {"
iX
oo
oo
Tj
nw
yt
oo
nw
Tj
oo
oo
QB
yv
yv
yv
CD
QB
oo
oo
iX
"}
(9,1,2) = {"
iX
oo
oo
Tj
Tj
Tj
Tj
Tj
oo
oo
oo
QB
xq
CD
nw
nw
QB
oo
oo
iX
"}
(10,1,2) = {"
oo
oo
oo
oo
oo
oo
oo
oo
oo
oo
oo
QB
ri
nw
CD
CD
QB
oo
oo
oo
"}
(11,1,2) = {"
oo
oo
oo
oo
oo
oo
oo
oo
oo
oo
oo
QB
EJ
nw
nw
aF
QB
oo
oo
oo
"}
(12,1,2) = {"
iX
oo
oo
QB
QB
QB
QB
QB
QB
oo
oo
QB
QB
QB
EU
QB
QB
oo
oo
iX
"}
(13,1,2) = {"
iX
oo
oo
QB
Qb
Jl
EK
ix
QB
oo
oo
oo
oo
oo
tm
oo
oo
oo
oo
iX
"}
(14,1,2) = {"
iX
oo
oo
QB
nw
nw
nw
nw
oo
oo
oo
oo
oo
oo
Hv
oo
oo
oo
oo
iX
"}
(15,1,2) = {"
iX
oo
oo
QB
oo
nw
nw
nw
QB
oo
oo
oo
QB
QB
Hv
QB
QB
oo
oo
iX
"}
(16,1,2) = {"
iX
oo
oo
QB
ch
nw
nw
nw
oo
oo
oo
oo
oo
oo
nw
Bv
QB
oo
oo
iX
"}
(17,1,2) = {"
iX
oo
oo
QB
QB
QB
QB
QB
QB
oo
oo
oo
QB
nw
jS
nw
QB
oo
oo
iX
"}
(18,1,2) = {"
iX
oo
oo
oo
oo
oo
oo
oo
oo
oo
oo
oo
QB
nw
nw
nw
QB
oo
oo
iX
"}
(19,1,2) = {"
iX
oo
oo
oo
oo
oo
oo
oo
oo
oo
oo
oo
QB
QB
QB
QB
QB
oo
oo
iX
"}
(20,1,2) = {"
iX
iX
iX
iX
iX
iX
iX
iX
iX
oo
oo
oo
iX
iX
iX
iX
iX
iX
iX
iX
"}
