//MAP CONVERTED BY dmm2tgm.py THIS HEADER COMMENT PREVENTS RECONVERSION, DO NOT REMOVE
"bF" = (
/obj/effect/decal/remains/bigrat,
/turf/open/floor/churchrough,
/area/rogue/indoors/shelter)
"bR" = (
/obj/structure/bookcase,
/obj/item/book/random_book,
/turf/open/floor/ruinedwood/darker,
/area/rogue/indoors/shelter)
"bS" = (
/obj/item/book/random_book,
/turf/open/floor/churchrough,
/area/rogue/indoors/shelter)
"cG" = (
/obj/effect/decal/cleanable/shreds,
/obj/structure/fluff/railing/wood{
	dir = 4
	},
/turf/open/floor/ruinedwood/darker,
/area/rogue/indoors/shelter)
"cR" = (
/obj/structure/rack/shelf,
/obj/effect/decal/cleanable/shreds,
/turf/open/floor/churchrough,
/area/rogue/indoors/shelter)
"dD" = (
/obj/effect/decal/cleanable/generic,
/obj/structure/fluff/railing/wood,
/turf/open/floor/churchrough,
/area/rogue/indoors/shelter)
"eH" = (
/obj/machinery/light/fueled/wallfire/candle/blue/l,
/turf/open/transparent/openspace,
/area/rogue/indoors/shelter)
"fH" = (
/obj/machinery/light/fueled/wallfire/candle/blue/r,
/obj/effect/decal/cleanable/generic,
/turf/open/floor/churchrough,
/area/rogue/indoors/shelter)
"fO" = (
/obj/effect/decal/remains/bigrat,
/obj/item/book/random_book,
/turf/open/floor/churchrough,
/area/rogue/indoors/shelter)
"gp" = (
/obj/effect/dungeon_directional_helper/west,
/turf/open/floor/churchrough,
/area/rogue/indoors/shelter)
"gV" = (
/obj/effect/decal/cleanable/generic,
/obj/structure/fluff/railing/wood{
	dir = 1
	},
/turf/open/floor/churchrough,
/area/rogue/indoors/shelter)
"hl" = (
/obj/structure/fluff/railing/wood{
	dir = 1
	},
/turf/open/floor/churchrough,
/area/rogue/indoors/shelter)
"hm" = (
/obj/structure/bookcase,
/obj/item/book/random_book,
/obj/item/book/random_book,
/turf/open/floor/churchrough,
/area/rogue/indoors/shelter)
"hp" = (
/turf/open/floor/ruinedwood/darker,
/area/rogue/indoors/shelter)
"is" = (
/obj/item/gem/green,
/turf/closed/wall/mineral/underbrick,
/area/rogue/indoors/shelter)
"iH" = (
/obj/structure/stairs{
	dir = 4
	},
/turf/open/floor/ruinedwood,
/area/rogue/indoors/shelter)
"iK" = (
/obj/effect/decal/cleanable/generic,
/turf/open/floor/churchrough,
/area/rogue/indoors/shelter)
"jr" = (
/obj/effect/dungeon_directional_helper/east,
/turf/open/floor/churchrough,
/area/rogue/indoors/shelter)
"jY" = (
/obj/structure/bookcase,
/obj/item/book/random_book,
/turf/open/floor/churchrough,
/area/rogue/indoors/shelter)
"lr" = (
/obj/structure/bookcase,
/obj/item/book/random_book,
/obj/item/book/random_book,
/obj/item/book/random_book,
/turf/open/floor/churchrough,
/area/rogue/indoors/shelter)
"lG" = (
/obj/effect/decal/cleanable/generic,
/obj/structure/fluff/railing/wood{
	dir = 1
	},
/turf/open/floor/ruinedwood/darker,
/area/rogue/indoors/shelter)
"mC" = (
/obj/effect/decal/cleanable/shreds,
/turf/open/floor/ruinedwood/darker,
/area/rogue/indoors/shelter)
"mK" = (
/obj/structure/fluff/railing/wood,
/turf/open/floor/ruinedwood/darker,
/area/rogue/indoors/shelter)
"nR" = (
/turf/closed/wall/mineral/wooddark,
/area/rogue/indoors/shelter)
"nW" = (
/obj/structure/fluff/railing/wood{
	dir = 8
	},
/turf/open/floor/ruinedwood/darker,
/area/rogue/indoors/shelter)
"oO" = (
/obj/structure/mineral_door/wood/violet,
/turf/open/floor/ruinedwood/darker,
/area/rogue/indoors/shelter)
"ps" = (
/obj/item/natural/rock,
/turf/closed/wall/mineral/underbrick,
/area/rogue/indoors/shelter)
"qk" = (
/obj/structure/mineral_door/wood/violet,
/turf/open/floor/churchrough,
/area/rogue/indoors/shelter)
"rq" = (
/obj/effect/decal/cleanable/dirt,
/turf/open/floor/churchrough,
/area/rogue/indoors/shelter)
"rO" = (
/obj/effect/decal/cleanable/generic,
/obj/structure/fluff/railing/wood,
/turf/open/floor/ruinedwood/darker,
/area/rogue/indoors/shelter)
"rX" = (
/turf/open/floor/ruinedwood,
/area/rogue/indoors/shelter)
"sQ" = (
/obj/effect/decal/cleanable/dirt/cobweb/cobweb2,
/turf/open/floor/churchrough,
/area/rogue/indoors/shelter)
"tz" = (
/turf/open/transparent/openspace,
/area/rogue/indoors/shelter)
"tT" = (
/obj/structure/bookcase,
/obj/item/book/random_book,
/obj/item/book/random_book,
/obj/item/book/random_book,
/obj/item/book/random_book,
/obj/item/book/random_book,
/obj/item/book/random_book,
/obj/item/book/random_book,
/obj/item/book/random_book,
/obj/item/book/random_book,
/obj/item/book/random_book,
/obj/item/book/random_book,
/turf/open/floor/churchrough,
/area/rogue/indoors/shelter)
"ue" = (
/obj/structure/bookcase,
/obj/item/book/random_book,
/obj/item/book/random_book,
/obj/item/book/random_book,
/obj/item/book/random_book,
/obj/item/book/random_book,
/turf/open/floor/churchrough,
/area/rogue/indoors/shelter)
"ur" = (
/obj/structure/stairs,
/turf/open/floor/ruinedwood,
/area/rogue/indoors/shelter)
"wU" = (
/obj/structure/bookcase,
/obj/item/book/random_book,
/obj/item/book/random_book,
/turf/open/floor/ruinedwood/darker,
/area/rogue/indoors/shelter)
"xm" = (
/obj/structure/bookcase,
/obj/item/book/random_book,
/obj/item/book/random_book,
/obj/item/book/random_book,
/obj/item/book/random_book,
/obj/item/book/random_book,
/turf/open/floor/ruinedwood/darker,
/area/rogue/indoors/shelter)
"xD" = (
/obj/effect/decal/cleanable/shreds,
/obj/item/book/random_book,
/turf/open/floor/churchrough,
/area/rogue/indoors/shelter)
"xE" = (
/obj/effect/decal/cleanable/dirt,
/obj/structure/fluff/railing/wood{
	dir = 4
	},
/turf/open/floor/ruinedwood/darker,
/area/rogue/indoors/shelter)
"ym" = (
/obj/effect/dungeon_directional_helper/north,
/turf/open/floor/churchrough,
/area/rogue/indoors/shelter)
"yw" = (
/obj/effect/decal/cleanable/dirt,
/turf/open/floor/ruinedwood/darker,
/area/rogue/indoors/shelter)
"zE" = (
/turf/closed/mineral/bedrock,
/area/rogue/indoors/shelter)
"Ax" = (
/obj/effect/decal/cleanable/dirt/cobweb{
	dir = 8
	},
/obj/structure/bookcase,
/obj/item/book/random_book,
/turf/open/floor/ruinedwood/darker,
/area/rogue/indoors/shelter)
"BB" = (
/obj/effect/decal/cleanable/dirt,
/obj/structure/fluff/railing/wood,
/turf/open/floor/churchrough,
/area/rogue/indoors/shelter)
"Ce" = (
/obj/structure/fluff/railing/wood,
/turf/open/floor/churchrough,
/area/rogue/indoors/shelter)
"DX" = (
/obj/structure/bookcase,
/obj/item/book/random_book,
/obj/item/book/random_book,
/obj/item/book/random_book,
/obj/item/book/random_book,
/obj/item/book/random_book,
/obj/item/book/random_book,
/obj/item/book/random_book,
/obj/item/book/random_book,
/obj/item/book/random_book,
/turf/open/floor/churchrough,
/area/rogue/indoors/shelter)
"GC" = (
/obj/effect/decal/cleanable/dirt,
/obj/effect/decal/cleanable/generic,
/turf/open/floor/churchrough,
/area/rogue/indoors/shelter)
"Hj" = (
/obj/effect/decal/cleanable/dirt/cobweb,
/obj/structure/rack/shelf,
/turf/open/floor/ruinedwood/darker,
/area/rogue/indoors/shelter)
"Hs" = (
/obj/effect/decal/cleanable/dirt/cobweb/cobweb2,
/obj/structure/bookcase,
/obj/item/book/random_book,
/obj/item/book/random_book,
/obj/item/book/random_book,
/obj/item/book/random_book,
/obj/item/book/random_book,
/obj/item/book/random_book,
/turf/open/floor/churchrough,
/area/rogue/indoors/shelter)
"Ht" = (
/obj/structure/stairs{
	dir = 8
	},
/turf/open/floor/ruinedwood,
/area/rogue/indoors/shelter)
"Hx" = (
/obj/structure/bookcase,
/obj/item/book/random_book,
/obj/item/book/random_book,
/obj/item/book/random_book,
/turf/open/floor/ruinedwood/darker,
/area/rogue/indoors/shelter)
"In" = (
/obj/effect/decal/cleanable/dirt/cobweb{
	dir = 4
	},
/turf/open/floor/ruinedwood/darker,
/area/rogue/indoors/shelter)
"It" = (
/obj/structure/fluff/railing/wood{
	dir = 8
	},
/turf/open/floor/churchrough,
/area/rogue/indoors/shelter)
"IT" = (
/obj/effect/decal/cleanable/generic,
/obj/structure/fluff/railing/wood{
	dir = 8
	},
/turf/open/floor/churchrough,
/area/rogue/indoors/shelter)
"Ku" = (
/turf/open/floor/churchrough,
/area/rogue/indoors/shelter)
"LE" = (
/obj/structure/stairs{
	dir = 1
	},
/turf/open/floor/ruinedwood,
/area/rogue/indoors/shelter)
"NW" = (
/obj/structure/fluff/railing/wood{
	dir = 4
	},
/turf/open/floor/ruinedwood/darker,
/area/rogue/indoors/shelter)
"Ra" = (
/obj/effect/decal/cleanable/dirt/cobweb{
	dir = 4
	},
/obj/structure/bookcase,
/turf/open/floor/churchrough,
/area/rogue/indoors/shelter)
"Rg" = (
/turf/closed/wall/mineral/underbrick,
/area/rogue/indoors/shelter)
"Si" = (
/obj/effect/decal/remains/bigrat,
/obj/item/book/random_book,
/turf/open/floor/ruinedwood/darker,
/area/rogue/indoors/shelter)
"Sr" = (
/obj/effect/decal/cleanable/dirt/cobweb,
/obj/structure/rack/shelf,
/turf/open/floor/churchrough,
/area/rogue/indoors/shelter)
"Tw" = (
/obj/effect/decal/cleanable/dirt/cobweb{
	dir = 8
	},
/turf/open/floor/churchrough,
/area/rogue/indoors/shelter)
"UC" = (
/obj/effect/decal/cleanable/dirt/cobweb,
/turf/open/floor/ruinedwood/darker,
/area/rogue/indoors/shelter)
"UX" = (
/obj/structure/bookcase,
/obj/item/book/random_book,
/obj/item/book/random_book,
/obj/item/book/random_book,
/obj/item/book/random_book,
/obj/item/book/random_book,
/obj/item/book/random_book,
/turf/open/floor/churchrough,
/area/rogue/indoors/shelter)
"VP" = (
/obj/structure/fluff/railing/wood{
	dir = 1
	},
/turf/open/floor/ruinedwood/darker,
/area/rogue/indoors/shelter)
"Xx" = (
/obj/effect/dungeon_directional_helper/south,
/turf/open/floor/churchrough,
/area/rogue/indoors/shelter)
"XA" = (
/obj/structure/rack/shelf,
/obj/effect/decal/cleanable/dirt/cobweb/cobweb2,
/turf/open/floor/ruinedwood/darker,
/area/rogue/indoors/shelter)

(1,1,1) = {"
zE
zE
zE
zE
zE
Ku
Ku
gp
Ku
Ku
zE
zE
zE
zE
zE
"}
(2,1,1) = {"
zE
Rg
Rg
Rg
Rg
Rg
qk
Rg
qk
Rg
Rg
Rg
Rg
Rg
zE
"}
(3,1,1) = {"
zE
Rg
Rg
ps
Sr
ue
Ku
Ku
Ku
iK
tT
Rg
Rg
Rg
zE
"}
(4,1,1) = {"
zE
Rg
Rg
rq
bS
DX
Ku
xD
iK
ue
bS
Ku
Rg
Rg
zE
"}
(5,1,1) = {"
zE
Rg
jY
rq
rq
ue
iK
Ku
Ku
jY
rq
rq
Ra
Rg
zE
"}
(6,1,1) = {"
Ku
Rg
UX
GC
Ku
Ku
Ku
Ku
Ku
rq
rq
bF
lr
Rg
Ku
"}
(7,1,1) = {"
Ku
qk
Ku
iK
Ce
rX
rX
rX
nR
nR
Ku
Ku
Ku
qk
Ku
"}
(8,1,1) = {"
ym
Rg
Ku
Ku
Ce
iH
iH
Rg
Ht
Ht
hl
iK
Ku
Rg
Xx
"}
(9,1,1) = {"
Ku
qk
Ku
bS
dD
rX
rX
ur
rX
rX
gV
Ku
Ku
qk
Ku
"}
(10,1,1) = {"
Ku
Rg
jY
rq
BB
rX
rX
ur
rX
rX
hl
Ku
ue
Rg
Ku
"}
(11,1,1) = {"
zE
Rg
Hs
fO
rq
IT
It
It
It
It
rq
Ku
hm
Rg
zE
"}
(12,1,1) = {"
zE
Rg
Rg
sQ
iK
jY
iK
Ku
Ku
tT
rq
Tw
Rg
Rg
zE
"}
(13,1,1) = {"
zE
Rg
Rg
Rg
cR
hm
Ku
fH
Ku
UX
Tw
Rg
Rg
Rg
zE
"}
(14,1,1) = {"
zE
Rg
Rg
Rg
Rg
Rg
qk
Rg
qk
Rg
Rg
Rg
Rg
Rg
zE
"}
(15,1,1) = {"
zE
zE
zE
zE
zE
Ku
Ku
jr
Ku
Ku
zE
zE
zE
zE
zE
"}

(1,1,2) = {"
zE
zE
zE
zE
zE
hp
hp
hp
hp
hp
zE
zE
zE
zE
zE
"}
(2,1,2) = {"
zE
Rg
Rg
Rg
Rg
Rg
tz
Rg
oO
Rg
Rg
Rg
Rg
Rg
zE
"}
(3,1,2) = {"
zE
Rg
Rg
Rg
Hj
xm
tz
eH
hp
hp
In
Rg
Rg
Rg
zE
"}
(4,1,2) = {"
zE
Rg
Rg
UC
tz
bR
hp
tz
tz
Hx
hp
tz
Rg
Rg
zE
"}
(5,1,2) = {"
zE
Rg
wU
Si
hp
cG
NW
tz
NW
xE
yw
hp
hp
Rg
zE
"}
(6,1,2) = {"
hp
Rg
bR
tz
mK
rX
rX
LE
rX
rX
VP
tz
tz
Rg
hp
"}
(7,1,2) = {"
hp
oO
yw
hp
rO
rX
rX
LE
Ht
Ht
VP
tz
hp
oO
hp
"}
(8,1,2) = {"
hp
Rg
hp
hp
mK
iH
iH
Rg
tz
tz
VP
tz
tz
Rg
hp
"}
(9,1,2) = {"
hp
oO
yw
hp
hp
rX
rX
tz
tz
tz
lG
hp
hp
oO
hp
"}
(10,1,2) = {"
hp
Rg
hp
yw
mK
rX
rX
tz
tz
tz
VP
hp
Hx
Rg
hp
"}
(11,1,2) = {"
zE
Rg
tz
tz
tz
tz
tz
nW
nW
nW
mC
hp
Ax
Rg
zE
"}
(12,1,2) = {"
zE
Rg
Rg
tz
tz
tz
tz
tz
hp
tz
tz
tz
Rg
Rg
zE
"}
(13,1,2) = {"
zE
Rg
Rg
is
XA
hp
tz
hp
yw
hp
hp
Rg
Rg
Rg
zE
"}
(14,1,2) = {"
zE
Rg
Rg
Rg
Rg
Rg
tz
Rg
oO
Rg
Rg
Rg
Rg
Rg
zE
"}
(15,1,2) = {"
zE
zE
zE
zE
zE
hp
hp
hp
hp
hp
zE
zE
zE
zE
zE
"}
