//MAP CONVERTED BY dmm2tgm.py THIS HEADER COMMENT PREVENTS RECONVERSION, DO NOT REMOVE
"ar" = (
/obj/structure/table/wood/fancy/red,
/obj/item/plate,
/obj/item/kitchen/fork/iron{
	pixel_x = -10
	},
/obj/item/organ/stomach,
/turf/open/floor/blocks/stonered/tiny,
/area/rogue/under/tomb)
"as" = (
/obj/machinery/light/fueled/torchholder,
/turf/closed/wall/mineral/decostone/cand/reddish,
/area/rogue/under/tomb)
"ax" = (
/obj/effect/decal/cleanable/blood/drip,
/turf/open/floor/dirt,
/area/rogue/under/tomb)
"bf" = (
/obj/structure/table/wood/fancy/red,
/obj/item/plate,
/obj/item/kitchen/fork/iron{
	pixel_x = -10
	},
/obj/item/organ/ears/cat,
/turf/open/floor/blocks/stonered/tiny,
/area/rogue/under/tomb)
"bm" = (
/turf/open/water/swamp,
/area/rogue/under/tomb)
"bG" = (
/obj/structure/stairs/fancy/l,
/turf/open/floor/blocks/stonered,
/area/rogue/under/tomb/indoors/royal)
"bU" = (
/mob/living/carbon/human/species/orc/tribal,
/obj/effect/decal/cleanable/blood,
/turf/open/water/swamp,
/area/rogue/under/tomb)
"cn" = (
/obj/structure/fluff/railing/border{
	layer = 2
	},
/turf/open/floor/blocks/stonered/tiny,
/area/rogue/under/tomb)
"cv" = (
/obj/effect/decal/cleanable/blood,
/obj/structure/fluff/statue/femalestatue{
	pixel_y = -25
	},
/turf/open/floor/plasteel/maniac,
/area/rogue/under/tomb)
"cO" = (
/obj/structure/bars/cemetery,
/turf/open/floor/dirt,
/area/rogue/under/tomb)
"de" = (
/obj/effect/decal/remains/human,
/turf/open/floor/dirt,
/area/rogue/under/tomb)
"dv" = (
/obj/effect/dungeon_directional_helper/south,
/turf/open/floor/blocks/stonered,
/area/rogue/under/tomb)
"dw" = (
/obj/machinery/light/fueled/torchholder,
/turf/closed/wall/mineral/stonebrick/reddish,
/area/rogue/under/tomb/indoors)
"eh" = (
/obj/structure/rack/shelf/big,
/turf/open/floor/blocks/stonered,
/area/rogue/under/tomb/indoors/royal)
"ex" = (
/obj/structure/table/wood/fancy/red,
/obj/item/plate,
/obj/item/kitchen/fork/iron{
	pixel_x = -10
	},
/obj/item/organ/liver,
/turf/open/floor/blocks/stonered/tiny,
/area/rogue/under/tomb)
"eN" = (
/obj/effect/decal/remains/human{
	pixel_x = 6
	},
/turf/open/floor/dirt,
/area/rogue/under/tomb)
"fq" = (
/obj/structure/fluff/walldeco/med6,
/turf/closed/wall/mineral/stonebrick/reddish,
/area/rogue/under/tomb)
"fI" = (
/obj/structure/table/wood/fancy/red,
/obj/item/plate,
/obj/item/kitchen/fork/iron{
	pixel_x = -10
	},
/obj/item/organ/heart,
/turf/open/floor/blocks/stonered/tiny,
/area/rogue/under/tomb)
"gq" = (
/obj/structure/fluff/walldeco/skullspike,
/obj/structure/flora/grass/bush_meagre/bog,
/turf/open/floor/grass/red,
/area/rogue/under/tomb)
"gy" = (
/obj/effect/decal/cleanable/blood,
/turf/open/floor/blocks/stonered,
/area/rogue/under/tomb)
"gA" = (
/obj/machinery/light/fueled/torchholder/l,
/obj/item/ingot/gold,
/turf/open/floor/blocks/stonered,
/area/rogue/under/tomb)
"gN" = (
/mob/living/carbon/human/species/skeleton/npc/no_equipment,
/obj/item/clothing/shoes/nobleboot,
/obj/item/clothing/shirt/tunic/noblecoat,
/obj/item/clothing/head/fancyhat,
/obj/item/clothing/gloves/chain,
/obj/item/clothing/pants/chainlegs/iron,
/obj/item/clothing/face/facemask/goldmask,
/obj/effect/mapping_helpers/floor_clothing_equipper,
/obj/item/weapon/sword/rapier/ironestoc,
/turf/open/floor/carpet/lord/center,
/area/rogue/under/tomb/indoors/royal)
"hg" = (
/obj/structure/chair/wood/alt{
	dir = 8
	},
/turf/open/floor/blocks/stonered/tiny,
/area/rogue/under/tomb)
"hy" = (
/obj/structure/fluff/railing/border{
	dir = 1
	},
/obj/structure/chair/wood/alt{
	dir = 8
	},
/turf/open/floor/blocks/stonered/tiny,
/area/rogue/under/tomb)
"hX" = (
/obj/item/plate{
	pixel_y = -10
	},
/obj/item/plate{
	pixel_y = -9
	},
/obj/item/plate{
	pixel_y = -8
	},
/obj/item/plate{
	pixel_y = -7
	},
/obj/item/plate{
	pixel_y = -6
	},
/obj/item/plate{
	pixel_y = -5
	},
/obj/item/plate{
	pixel_y = -4
	},
/obj/item/plate{
	pixel_y = -3
	},
/obj/item/plate{
	pixel_y = -2
	},
/obj/item/plate{
	pixel_y = -1
	},
/obj/item/plate,
/turf/open/floor/tile/checker,
/area/rogue/under/tomb/indoors)
"io" = (
/turf/closed/wall/mineral/stonebrick/reddish,
/area/rogue/under/tomb)
"iy" = (
/obj/effect/decal/remains/human{
	pixel_x = 6;
	pixel_y = 12
	},
/turf/open/floor/dirt,
/area/rogue/under/tomb)
"iI" = (
/obj/effect/decal/cleanable/blood,
/obj/effect/decal/cleanable/blood/tracks{
	dir = 4
	},
/obj/structure/fluff/statue/femalestatue,
/turf/open/floor/churchbrick,
/area/rogue/under/tomb)
"iK" = (
/obj/structure/fluff/railing/border{
	dir = 8
	},
/obj/structure/fluff/railing/border{
	dir = 1
	},
/obj/structure/chair/wood/alt{
	dir = 8
	},
/turf/open/floor/blocks/stonered/tiny,
/area/rogue/under/tomb)
"je" = (
/mob/living/carbon/human/species/orc/tribal,
/obj/item/organ/guts,
/obj/effect/decal/cleanable/blood/gibs/down,
/obj/effect/decal/cleanable/blood,
/obj/effect/spawner/map_spawner/loot/common,
/turf/open/water/swamp,
/area/rogue/under/tomb)
"jg" = (
/obj/effect/decal/cleanable/blood/gibs/limb,
/turf/open/water/swamp,
/area/rogue/under/tomb)
"ji" = (
/obj/structure/fluff/railing/border{
	dir = 8
	},
/obj/structure/fluff/railing/border{
	layer = 2
	},
/turf/open/floor/blocks/stonered/tiny,
/area/rogue/under/tomb)
"jH" = (
/obj/structure/closet/crate/chest/crate,
/obj/item/organ/eyes,
/obj/item/organ/eyes/elf/less,
/obj/item/organ/eyes/night_vision/werewolf,
/obj/item/organ/stomach,
/obj/item/organ/stomach,
/obj/item/organ/lungs,
/obj/item/organ/lungs,
/obj/item/organ/lungs,
/obj/item/organ/liver,
/obj/item/organ/guts,
/obj/item/organ/heart,
/obj/item/organ/heart,
/obj/item/organ/tongue,
/obj/item/organ/tongue,
/obj/item/organ/ears,
/turf/open/floor/tile/checker,
/area/rogue/under/tomb/indoors)
"jW" = (
/turf/open/floor/tile/checker,
/area/rogue/under/tomb/indoors)
"jZ" = (
/obj/structure/fluff/railing/border{
	dir = 1
	},
/turf/open/floor/blocks/stonered/tiny,
/area/rogue/under/tomb)
"kv" = (
/obj/effect/decal/cleanable/blood/tracks,
/turf/open/floor/tile/checker,
/area/rogue/under/tomb/indoors)
"kx" = (
/obj/effect/decal/remains/human,
/obj/effect/decal/remains/human{
	pixel_x = 6
	},
/turf/open/floor/dirt,
/area/rogue/under/tomb)
"ky" = (
/turf/open/floor/carpet/lord/left{
	dir = 1
	},
/area/rogue/under/tomb/indoors/royal)
"kE" = (
/obj/structure/fluff/railing/border{
	dir = 8
	},
/obj/structure/fluff/railing/border{
	dir = 1
	},
/turf/open/floor/blocks/stonered/tiny,
/area/rogue/under/tomb)
"le" = (
/mob/living/carbon/human/species/orc/tribal,
/turf/open/water/swamp,
/area/rogue/under/tomb)
"lx" = (
/obj/machinery/light/fueled/torchholder/l,
/turf/open/floor/blocks/stonered,
/area/rogue/under/tomb)
"lR" = (
/obj/effect/decal/cleanable/blood,
/turf/open/water/swamp,
/area/rogue/under/tomb)
"me" = (
/obj/effect/dungeon_directional_helper/east,
/turf/open/floor/blocks/stonered,
/area/rogue/under/tomb)
"mi" = (
/obj/structure/rack/shelf/big,
/obj/machinery/light/fueled/torchholder/c,
/turf/open/floor/blocks/stonered,
/area/rogue/under/tomb/indoors/royal)
"mu" = (
/obj/machinery/light/fueled/torchholder,
/turf/closed/wall/mineral/decostone/cand/reddish,
/area/rogue/under/tomb/indoors)
"mF" = (
/obj/effect/decal/remains/human,
/obj/effect/decal/remains/human{
	pixel_x = 6;
	pixel_y = 12
	},
/obj/effect/decal/remains/human{
	pixel_x = 6
	},
/obj/effect/spawner/map_spawner/loot/weapon,
/turf/open/floor/dirt,
/area/rogue/under/tomb)
"mH" = (
/obj/machinery/light/fueled/torchholder/c,
/turf/open/floor/blocks/stonered/tiny,
/area/rogue/under/tomb)
"nf" = (
/obj/effect/decal/cleanable/blood/tracks{
	dir = 10
	},
/obj/structure/table/optable,
/turf/open/floor/tile/checker,
/area/rogue/under/tomb/indoors)
"ni" = (
/obj/effect/decal/remains/human,
/obj/effect/decal/remains/human{
	pixel_x = 6
	},
/obj/effect/spawner/map_spawner/loot/weapon,
/turf/open/floor/dirt,
/area/rogue/under/tomb)
"nk" = (
/turf/open/floor/grass/red,
/area/rogue/under/tomb)
"nG" = (
/obj/effect/decal/cleanable/blood,
/obj/effect/decal/cleanable/blood/tracks{
	dir = 4
	},
/turf/open/floor/churchbrick,
/area/rogue/under/tomb)
"nJ" = (
/obj/structure/fluff/railing/border{
	dir = 8
	},
/obj/machinery/light/fueled/torchholder/c,
/turf/open/floor/blocks/stonered/tiny,
/area/rogue/under/tomb)
"nR" = (
/turf/closed/wall/mineral/stonebrick/reddish,
/area/rogue/under/tomb/indoors)
"nZ" = (
/obj/structure/door/iron/bars,
/turf/open/floor/dirt,
/area/rogue/under/tomb)
"oi" = (
/obj/effect/decal/cleanable/blood/tracks{
	dir = 4
	},
/obj/structure/fluff/statue/femalestatue,
/turf/open/floor/churchbrick,
/area/rogue/under/tomb)
"oZ" = (
/obj/item/clothing/ring/gold/dorpel,
/obj/effect/decal/cleanable/blood,
/turf/open/water/swamp,
/area/rogue/under/tomb)
"pc" = (
/obj/effect/decal/remains/human{
	pixel_x = 6;
	pixel_y = 12
	},
/obj/effect/spawner/map_spawner/loot/armor,
/turf/open/floor/dirt,
/area/rogue/under/tomb)
"pg" = (
/obj/effect/decal/cleanable/blood/tracks{
	dir = 10
	},
/turf/open/floor/tile/checker,
/area/rogue/under/tomb/indoors)
"ps" = (
/obj/structure/fluff/walldeco/med4,
/turf/closed/wall/mineral/stonebrick/reddish,
/area/rogue/under/tomb)
"qw" = (
/obj/effect/decal/cleanable/blood/gibs,
/turf/open/water/swamp,
/area/rogue/under/tomb)
"qz" = (
/turf/open/floor/plasteel/maniac,
/area/rogue/under/tomb)
"qK" = (
/obj/effect/decal/cleanable/blood,
/turf/open/floor/grass/red,
/area/rogue/under/tomb)
"qL" = (
/obj/structure/fluff/railing/border{
	dir = 8
	},
/turf/open/floor/blocks/stonered/tiny,
/area/rogue/under/tomb)
"qP" = (
/turf/open/floor/blocks/stonered,
/area/rogue/under/tomb)
"qU" = (
/obj/structure/door/iron/bars,
/turf/open/floor/blocks/stonered,
/area/rogue/under/tomb)
"qW" = (
/obj/structure/closet/crate/chest/gold,
/obj/item/weapon/knife/cleaver,
/obj/item/clothing/cloak/apron/cook,
/obj/item/clothing/head/sack,
/obj/item/weapon/polearm/spear/stone/copper,
/obj/item/clothing/armor/leather/vest/butcher,
/turf/open/floor/tile/checker,
/area/rogue/under/tomb/indoors)
"rx" = (
/obj/effect/decal/cleanable/blood,
/obj/effect/decal/cleanable/blood,
/turf/open/floor/plasteel/maniac,
/area/rogue/under/tomb)
"rP" = (
/turf/closed/wall/mineral/decostone/cand/reddish,
/area/rogue/under/tomb/indoors/royal)
"rQ" = (
/obj/structure/door/red,
/obj/effect/mapping_helpers/door/locker,
/turf/open/floor/blocks/stonered,
/area/rogue/under/tomb/indoors/royal)
"sk" = (
/obj/structure/fluff/walldeco/skullspike,
/turf/open/floor/plasteel/maniac,
/area/rogue/under/tomb)
"sp" = (
/obj/structure/table/wood/fancy/red,
/obj/item/plate,
/obj/item/kitchen/fork/iron{
	pixel_x = -10
	},
/obj/item/organ/lungs,
/turf/open/floor/blocks/stonered/tiny,
/area/rogue/under/tomb)
"sz" = (
/obj/effect/decal/cleanable/blood/tracks{
	dir = 4
	},
/turf/open/floor/tile/checker,
/area/rogue/under/tomb/indoors)
"sM" = (
/obj/effect/decal/cleanable/blood/gibs,
/obj/effect/decal/cleanable/blood,
/obj/effect/spawner/map_spawner/loot/common,
/turf/open/water/swamp,
/area/rogue/under/tomb)
"sR" = (
/obj/machinery/light/fueled/firebowl/standing,
/turf/open/floor/blocks/stonered/tiny,
/area/rogue/under/tomb)
"sW" = (
/turf/open/floor/dirt,
/area/rogue/under/tomb)
"td" = (
/obj/structure/stairs/fancy/l{
	dir = 1
	},
/turf/open/floor/blocks/stonered,
/area/rogue/under/tomb/indoors/royal)
"tp" = (
/mob/living/carbon/human/species/skeleton/npc/warrior/skilled,
/turf/open/floor/blocks/stonered,
/area/rogue/under/tomb/indoors/royal)
"tq" = (
/obj/effect/decal/cleanable/blood/drip{
	pixel_x = 9;
	pixel_y = -6
	},
/turf/open/floor/plasteel/maniac,
/area/rogue/under/tomb)
"uc" = (
/obj/effect/decal/cleanable/blood/gibs,
/obj/effect/decal/cleanable/blood,
/turf/open/water/swamp,
/area/rogue/under/tomb)
"uZ" = (
/obj/structure/fluff/railing/border{
	dir = 8
	},
/obj/structure/fluff/railing/border{
	layer = 2
	},
/obj/structure/chair/wood/alt{
	dir = 8
	},
/turf/open/floor/blocks/stonered/tiny,
/area/rogue/under/tomb)
"vj" = (
/obj/effect/decal/cleanable/blood/gibs/down,
/turf/open/water/swamp,
/area/rogue/under/tomb)
"vO" = (
/obj/effect/decal/cleanable/blood/tracks{
	dir = 4
	},
/obj/effect/decal/cleanable/blood/tracks{
	dir = 4
	},
/turf/open/floor/churchbrick,
/area/rogue/under/tomb)
"vU" = (
/obj/structure/stairs/fancy/r,
/turf/open/floor/blocks/stonered,
/area/rogue/under/tomb/indoors/royal)
"vW" = (
/obj/machinery/light/fueled/firebowl,
/turf/open/floor/blocks/stonered,
/area/rogue/under/tomb)
"wc" = (
/obj/effect/decal/remains/human,
/obj/effect/decal/remains/human{
	pixel_x = 6;
	pixel_y = 12
	},
/obj/effect/decal/remains/human{
	pixel_x = 6
	},
/turf/open/floor/dirt,
/area/rogue/under/tomb)
"wp" = (
/obj/item/organ/guts,
/turf/open/water/swamp,
/area/rogue/under/tomb)
"wC" = (
/mob/living/carbon/human/species/orc/warlord/skilled,
/turf/open/floor/tile/checker,
/area/rogue/under/tomb/indoors)
"wL" = (
/mob/living/carbon/human/species/orc/marauder,
/turf/open/floor/blocks/stonered,
/area/rogue/under/tomb)
"wS" = (
/turf/open/floor/carpet/lord/right{
	dir = 1
	},
/area/rogue/under/tomb/indoors/royal)
"xf" = (
/turf/open/floor/blocks/stonered,
/area/rogue/under/tomb/indoors/royal)
"xH" = (
/obj/structure/fluff/railing/border{
	dir = 8
	},
/obj/structure/fluff/signage{
	dir = 1;
	desc = "LIVE MEAT GOES HERE";
	name = "Throw live meat in pit, rejoice, it squirms and screams !"
	},
/turf/open/floor/blocks/stonered/tiny,
/area/rogue/under/tomb)
"xX" = (
/obj/effect/decal/cleanable/blood,
/turf/open/floor/dirt,
/area/rogue/under/tomb)
"yj" = (
/obj/structure/fluff/walldeco/skullspike,
/turf/open/floor/grass/red,
/area/rogue/under/tomb)
"ym" = (
/obj/effect/decal/cleanable/blood/drip,
/obj/effect/decal/cleanable/blood,
/obj/effect/decal/cleanable/blood/tracks{
	dir = 4
	},
/obj/effect/decal/cleanable/blood/tracks{
	dir = 4
	},
/turf/open/floor/churchbrick,
/area/rogue/under/tomb)
"yR" = (
/obj/machinery/light/fueled/torchholder,
/turf/closed/wall/mineral/decostone/cand/reddish,
/area/rogue/under/tomb/indoors/royal)
"zo" = (
/turf/closed/wall/mineral/stonebrick/reddish,
/area/rogue/under/tomb/indoors/royal)
"zp" = (
/obj/structure/chair/wood/alt{
	dir = 8
	},
/obj/effect/spawner/map_spawner/loot/common,
/turf/open/floor/blocks/stonered/tiny,
/area/rogue/under/tomb)
"zz" = (
/obj/structure/fluff/railing/border{
	dir = 9
	},
/turf/open/floor/blocks/stonered/tiny,
/area/rogue/under/tomb)
"zI" = (
/turf/open/floor/carpet/lord/center,
/area/rogue/under/tomb/indoors/royal)
"Ae" = (
/obj/structure/fluff/statue/femalestatue{
	pixel_y = -25
	},
/turf/open/floor/plasteel/maniac,
/area/rogue/under/tomb)
"Aq" = (
/obj/structure/flora/grass/bush_meagre/bog,
/turf/open/floor/grass/red,
/area/rogue/under/tomb)
"AA" = (
/obj/machinery/light/fueled/firebowl,
/turf/open/floor/plasteel/maniac,
/area/rogue/under/tomb)
"AG" = (
/turf/closed/wall/mineral/decostone/cand/reddish,
/area/rogue/under/tomb/indoors)
"AN" = (
/obj/effect/dungeon_directional_helper/west,
/turf/open/floor/tile/checker,
/area/rogue/under/tomb/indoors)
"Bd" = (
/obj/structure/innocent_bush,
/turf/open/floor/grass/red,
/area/rogue/under/tomb)
"Bz" = (
/obj/structure/handcart{
	dir = 4;
	desc = "A wooden cart that will help you carry many things. You cant help but notice dried blood, pieces of viscera scattered across the wheel and inside..."
	},
/obj/machinery/light/fueled/oven/south,
/turf/open/floor/tile/checker,
/area/rogue/under/tomb/indoors)
"BV" = (
/obj/structure/chair/wood/alt{
	dir = 8
	},
/mob/living/carbon/human/species/skeleton/npc/peasant,
/turf/open/floor/blocks/stonered/tiny,
/area/rogue/under/tomb)
"CF" = (
/obj/structure/fluff/railing/border{
	layer = 2
	},
/obj/structure/chair/wood/alt{
	dir = 8
	},
/obj/effect/spawner/map_spawner/loot/common,
/turf/open/floor/blocks/stonered/tiny,
/area/rogue/under/tomb)
"CI" = (
/obj/structure/fluff/walldeco/skullspike,
/obj/structure/innocent_bush,
/turf/open/floor/grass/red,
/area/rogue/under/tomb)
"CL" = (
/obj/structure/fluff/railing/border{
	layer = 2
	},
/obj/structure/chair/wood/alt{
	dir = 8
	},
/turf/open/floor/blocks/stonered/tiny,
/area/rogue/under/tomb)
"Dd" = (
/obj/effect/decal/cleanable/blood/gibs/down,
/obj/effect/spawner/map_spawner/loot/common,
/turf/open/water/swamp,
/area/rogue/under/tomb)
"Dj" = (
/obj/machinery/light/fueled/torchholder/r,
/turf/open/floor/blocks/stonered/tiny,
/area/rogue/under/tomb)
"DE" = (
/obj/structure/table/wood/fancy/black,
/obj/item/reagent_containers/glass/cup/golden{
	pixel_y = 9;
	pixel_x = 8
	},
/obj/item/reagent_containers/glass/carafe/gold/redwine{
	pixel_y = 6;
	pixel_x = -7
	},
/turf/open/floor/carpet/lord/center,
/area/rogue/under/tomb/indoors/royal)
"Et" = (
/obj/structure/window/solid,
/turf/open/floor/blocks/stonered/tiny,
/area/rogue/under/tomb/indoors/royal)
"Fn" = (
/obj/machinery/light/fueled/torchholder,
/turf/closed/wall/mineral/stonebrick/reddish,
/area/rogue/under/tomb)
"Fs" = (
/turf/closed/wall/mineral/decostone/cand/reddish,
/area/rogue/under/tomb)
"Gx" = (
/obj/structure/fluff/walldeco/painting/skull,
/turf/closed/wall/mineral/stonebrick/reddish,
/area/rogue/under/tomb/indoors/royal)
"Hp" = (
/turf/open/transparent/openspace,
/area/rogue/under/tomb)
"Hw" = (
/obj/effect/decal/cleanable/blood,
/turf/open/floor/plasteel/maniac,
/area/rogue/under/tomb)
"Jk" = (
/obj/machinery/light/fueled/firebowl,
/turf/open/floor/grass/red,
/area/rogue/under/tomb)
"Kj" = (
/obj/structure/fluff/walldeco/med5,
/turf/closed/wall/mineral/stonebrick/reddish,
/area/rogue/under/tomb)
"Kn" = (
/obj/item/ingot/gold,
/turf/open/floor/blocks/stonered,
/area/rogue/under/tomb)
"KU" = (
/obj/effect/decal/cleanable/blood,
/turf/open/floor/churchbrick,
/area/rogue/under/tomb)
"KW" = (
/obj/effect/decal/cleanable/blood/tracks{
	dir = 4
	},
/obj/machinery/light/fueled/torchholder/c,
/turf/open/floor/tile/checker,
/area/rogue/under/tomb/indoors)
"Lz" = (
/obj/effect/decal/cleanable/blood/drip,
/turf/open/floor/plasteel/maniac,
/area/rogue/under/tomb)
"LH" = (
/obj/structure/handcart{
	dir = 4;
	desc = "A wooden cart that will help you carry many things. You cant help but notice dried blood, pieces of viscera scattered across the wheel and inside..."
	},
/obj/item/organ/brain,
/turf/open/floor/blocks/stonered/tiny,
/area/rogue/under/tomb)
"Mk" = (
/obj/structure/fluff/walldeco/med2,
/turf/closed/wall/mineral/stonebrick/reddish,
/area/rogue/under/tomb)
"MG" = (
/obj/structure/chair/wood/alt{
	dir = 8
	},
/obj/machinery/light/fueled/torchholder/c,
/obj/effect/spawner/map_spawner/loot/common,
/turf/open/floor/blocks/stonered/tiny,
/area/rogue/under/tomb)
"MM" = (
/obj/effect/spawner/map_spawner/loot/common,
/turf/open/water/swamp,
/area/rogue/under/tomb)
"Ni" = (
/obj/structure/table/wood/fancy/red,
/obj/item/plate,
/obj/item/kitchen/fork/iron{
	pixel_x = -10
	},
/obj/item/organ/ears,
/turf/open/floor/blocks/stonered/tiny,
/area/rogue/under/tomb)
"NA" = (
/obj/machinery/light/fueled/torchholder/l,
/turf/open/floor/blocks/stonered/tiny,
/area/rogue/under/tomb)
"NY" = (
/obj/effect/decal/cleanable/blood/drip,
/obj/effect/decal/cleanable/blood/tracks{
	dir = 4
	},
/turf/open/floor/churchbrick,
/area/rogue/under/tomb)
"Of" = (
/obj/effect/spawner/map_spawner/loot/medium,
/turf/open/floor/grass/red,
/area/rogue/under/tomb)
"On" = (
/obj/structure/chair/wood/alt/chair_noble/purple{
	dir = 4
	},
/turf/open/floor/carpet/lord/center,
/area/rogue/under/tomb/indoors/royal)
"Or" = (
/mob/living/carbon/human/species/skeleton/npc/no_equipment,
/turf/open/floor/dirt,
/area/rogue/under/tomb)
"PQ" = (
/obj/structure/door/fancy,
/obj/effect/decal/cleanable/blood/tracks{
	dir = 4
	},
/turf/open/floor/churchbrick,
/area/rogue/under/tomb/indoors)
"Qm" = (
/obj/structure/table/wood/fancy/red,
/obj/item/plate,
/obj/item/kitchen/fork/iron{
	pixel_x = -10
	},
/obj/item/organ/guts,
/turf/open/floor/blocks/stonered/tiny,
/area/rogue/under/tomb)
"Qr" = (
/obj/effect/decal/cleanable/blood,
/obj/structure/door/red,
/obj/effect/mapping_helpers/door/locker,
/turf/open/floor/blocks/stonered,
/area/rogue/under/tomb/indoors/royal)
"QM" = (
/obj/effect/decal/cleanable/blood/drip,
/turf/open/floor/blocks/stonered,
/area/rogue/under/tomb)
"QQ" = (
/obj/effect/decal/cleanable/blood/gibs,
/obj/effect/spawner/map_spawner/loot/rare,
/turf/open/water/swamp,
/area/rogue/under/tomb)
"QU" = (
/obj/structure/fluff/railing/border{
	dir = 10
	},
/turf/open/floor/blocks/stonered/tiny,
/area/rogue/under/tomb)
"Rc" = (
/obj/effect/decal/cleanable/blood/drip{
	pixel_x = 9;
	pixel_y = -6
	},
/turf/open/floor/blocks/stonered,
/area/rogue/under/tomb)
"Rg" = (
/obj/structure/table/wood/fancy/red,
/obj/item/plate,
/obj/item/kitchen/fork/iron{
	pixel_x = -10
	},
/obj/item/organ/tongue,
/turf/open/floor/blocks/stonered/tiny,
/area/rogue/under/tomb)
"Rz" = (
/turf/open/floor/blocks/stonered/tiny,
/area/rogue/under/tomb)
"Sm" = (
/obj/effect/decal/cleanable/blood/drip,
/obj/structure/bars/cemetery,
/turf/open/floor/dirt,
/area/rogue/under/tomb)
"SM" = (
/obj/structure/table/wood/fancy/black,
/obj/item/reagent_containers/glass/bottle/whitewine{
	pixel_y = 15
	},
/turf/open/floor/carpet/lord/center,
/area/rogue/under/tomb/indoors/royal)
"Tq" = (
/obj/item/clothing/ring/gold/toper,
/obj/effect/decal/cleanable/blood/gibs/down,
/obj/effect/decal/cleanable/blood,
/turf/open/water/swamp,
/area/rogue/under/tomb)
"Uc" = (
/obj/effect/decal/cleanable/blood/tracks{
	dir = 4
	},
/obj/structure/table/optable,
/turf/open/floor/tile/checker,
/area/rogue/under/tomb/indoors)
"Um" = (
/obj/effect/dungeon_directional_helper/north,
/turf/open/floor/blocks/stonered,
/area/rogue/under/tomb)
"UD" = (
/turf/open/transparent/openspace,
/area/rogue/under/tomb/indoors/royal)
"VD" = (
/obj/effect/decal/cleanable/blood/drip,
/obj/effect/spawner/map_spawner/loot/medium,
/turf/open/floor/grass/red,
/area/rogue/under/tomb)
"VI" = (
/obj/effect/decal/cleanable/blood/drip,
/turf/open/floor/grass/red,
/area/rogue/under/tomb)
"Wb" = (
/obj/structure/fluff/walldeco/med3,
/turf/closed/wall/mineral/stonebrick/reddish,
/area/rogue/under/tomb/indoors)
"Wl" = (
/obj/machinery/light/fueled/firebowl/standing,
/turf/open/floor/carpet/lord/center,
/area/rogue/under/tomb/indoors/royal)
"WH" = (
/obj/structure/bars,
/turf/open/floor/plasteel/maniac,
/area/rogue/under/tomb)
"WX" = (
/obj/structure/table/wood/fancy/red,
/obj/item/plate,
/obj/item/kitchen/fork/iron{
	pixel_x = -10
	},
/obj/item/organ/eyes/elf,
/turf/open/floor/blocks/stonered/tiny,
/area/rogue/under/tomb)
"XB" = (
/obj/structure/handcart{
	dir = 4;
	desc = "A wooden cart that will help you carry many things. You cant help but notice dried blood, pieces of viscera scattered across the wheel and inside..."
	},
/obj/item/organ/lungs,
/obj/item/organ/eyes,
/turf/open/floor/blocks/stonered/tiny,
/area/rogue/under/tomb)
"XJ" = (
/obj/effect/spawner/map_spawner/loot/common,
/turf/open/floor/grass/red,
/area/rogue/under/tomb)
"XS" = (
/obj/effect/decal/remains/human,
/obj/effect/decal/remains/human{
	pixel_x = 6;
	pixel_y = 12
	},
/obj/effect/decal/remains/human{
	pixel_x = 6
	},
/obj/effect/spawner/map_spawner/loot/rare,
/turf/open/floor/dirt,
/area/rogue/under/tomb)
"Yf" = (
/obj/structure/fluff/railing/border{
	dir = 8
	},
/obj/structure/chair/wood/alt{
	dir = 8
	},
/turf/open/floor/blocks/stonered/tiny,
/area/rogue/under/tomb)
"Ys" = (
/obj/effect/decal/cleanable/blood/tracks{
	dir = 4
	},
/turf/open/floor/churchbrick,
/area/rogue/under/tomb)
"YF" = (
/obj/effect/spawner/map_spawner/loot/weapon,
/turf/open/floor/dirt,
/area/rogue/under/tomb)
"Zp" = (
/obj/structure/stairs/fancy/r{
	dir = 1
	},
/turf/open/floor/blocks/stonered,
/area/rogue/under/tomb/indoors/royal)
"Zz" = (
/obj/structure/fluff/sellsign{
	name = "INEDIBLE PARTS"
	},
/turf/open/floor/blocks/stonered,
/area/rogue/under/tomb)

(1,1,1) = {"
io
io
io
io
io
io
io
io
zo
zo
zo
zo
Wb
jW
jW
AN
jW
jW
dw
zo
zo
zo
zo
io
io
io
io
io
io
io
"}
(2,1,1) = {"
io
kx
sW
cO
qP
qP
qP
qP
rP
eh
eh
yR
nR
Bz
kv
nf
jW
jW
nR
rP
mi
eh
rP
qP
qP
qP
cO
wc
sW
io
"}
(3,1,1) = {"
io
Or
sW
Sm
Zz
qP
QM
gy
rQ
xf
xf
bG
nR
Bz
pg
sz
jW
jH
nR
td
xf
xf
rQ
qP
qP
Zz
cO
sW
wc
io
"}
(4,1,1) = {"
io
sW
sW
nZ
qP
qP
qP
qP
rQ
tp
xf
vU
nR
qW
sz
Uc
jW
hX
nR
Zp
xf
tp
rQ
qP
qP
qP
nZ
sW
sW
io
"}
(5,1,1) = {"
io
sW
xX
cO
vW
qP
qP
qP
rP
rQ
Qr
rP
nR
qW
sz
sz
jW
hX
nR
rP
rQ
Qr
rP
qP
qP
vW
cO
sW
sW
io
"}
(6,1,1) = {"
io
sW
xX
cO
gy
qP
qP
wL
qP
qP
qP
qP
nR
AG
KW
sz
wC
mu
nR
qP
qP
QM
qP
wL
qP
qP
cO
Or
sW
io
"}
(7,1,1) = {"
io
sW
sW
cO
qP
Rc
qP
qz
qz
Lz
qz
qz
AA
nR
PQ
PQ
nR
nR
AA
qz
qz
qz
qz
QM
qP
qP
cO
sW
kx
io
"}
(8,1,1) = {"
io
kx
sW
cO
qP
qP
qP
qz
Aq
nk
yj
Aq
qz
lx
Ys
nG
gA
qz
nk
nk
yj
Bd
qz
qP
qP
qP
Sm
ax
sW
io
"}
(9,1,1) = {"
io
Or
de
cO
qP
qP
qP
qz
nk
yj
nk
nk
qz
qP
Ys
nG
qP
qz
Aq
nk
Of
nk
qz
qP
gy
qP
cO
sW
Or
io
"}
(10,1,1) = {"
io
YF
iy
cO
qP
qP
qP
qz
nk
nk
Of
nk
Ae
qP
Ys
iI
qP
qz
VI
yj
nk
yj
qz
qP
Rc
qP
cO
sW
kx
io
"}
(11,1,1) = {"
io
eN
sW
cO
qP
qP
qP
qz
nk
nk
Bd
nk
qz
Kn
NY
Ys
qP
qz
nk
Aq
nk
nk
qz
qP
qP
qP
cO
de
sW
io
"}
(12,1,1) = {"
io
XS
ni
cO
qP
qP
qP
qz
qz
qz
qz
rx
qz
qP
vO
nG
gy
qz
qz
Hw
qz
qz
qz
qP
qP
qP
cO
pc
mF
io
"}
(13,1,1) = {"
io
io
io
io
vW
qP
qP
qz
qz
Hw
qz
Hw
cv
qP
vO
oi
qP
Lz
qz
qz
qz
tq
qz
qP
qP
vW
io
io
io
io
"}
(14,1,1) = {"
qP
qP
qP
qU
qP
qP
qP
qz
nk
nk
VI
yj
Hw
qP
vO
KU
qP
Hw
nk
nk
nk
nk
qz
qP
qP
qP
qU
qP
qP
qP
"}
(15,1,1) = {"
Um
qP
qP
ps
qP
qP
qP
qz
nk
nk
nk
nk
Hw
gy
vO
nG
Kn
qz
nk
nk
nk
nk
qz
qP
qP
qP
ps
qP
qP
dv
"}
(16,1,1) = {"
qP
qP
qP
qU
qP
QM
qP
qz
nk
Aq
XJ
nk
Ae
gy
ym
oi
qP
qz
Bd
nk
yj
nk
qz
qP
qP
qP
qU
qP
qP
qP
"}
(17,1,1) = {"
io
io
io
io
vW
qP
qP
qz
nk
nk
Jk
io
WH
io
Ys
Ys
Mk
WH
io
Jk
nk
nk
qz
qP
qP
vW
io
io
io
io
"}
(18,1,1) = {"
io
qP
qP
qP
qP
qP
qP
qz
qz
qz
qz
WH
le
bm
jg
bm
vj
bm
WH
qz
qz
qz
qz
qP
qP
qP
qP
qP
qP
io
"}
(19,1,1) = {"
io
qP
qP
tq
qz
qz
tq
qz
qz
qP
qP
ps
bm
wp
le
wp
MM
bm
io
qP
qP
qz
qz
qz
qz
qz
qz
qP
qP
io
"}
(20,1,1) = {"
io
qP
qP
qz
nk
Bd
nk
nk
qz
qP
qP
WH
bm
Dd
QQ
wp
qw
bm
WH
qP
qP
qz
yj
nk
Aq
yj
qz
qP
QM
io
"}
(21,1,1) = {"
io
qP
qP
qz
nk
XJ
yj
yj
qz
qP
qP
WH
bm
Tq
jg
lR
bU
bm
WH
qP
qP
qz
nk
nk
nk
nk
qz
qP
qP
io
"}
(22,1,1) = {"
io
qP
qP
qz
yj
nk
nk
nk
qz
qP
qP
io
bm
lR
bm
bm
oZ
bm
Kj
qP
qP
qz
nk
qK
VD
nk
sk
qP
qP
io
"}
(23,1,1) = {"
io
qP
qP
Lz
nk
nk
nk
Aq
qz
qP
qP
WH
lR
qw
je
uc
sM
bm
WH
qP
qP
qz
nk
Bd
nk
nk
qz
qP
qP
io
"}
(24,1,1) = {"
io
qP
qP
qz
qz
qz
qz
qz
qz
qP
qP
WH
wp
bm
MM
bm
bm
wp
WH
qP
gy
qz
qz
qz
qz
qz
tq
qP
qP
io
"}
(25,1,1) = {"
io
qP
qP
qz
qz
tq
Hw
qz
qz
qP
vW
io
WH
WH
fq
fq
WH
WH
io
vW
qP
qz
qz
Lz
qz
sk
qz
qP
qP
io
"}
(26,1,1) = {"
io
qP
qP
qz
nk
yj
XJ
gq
qz
qP
qP
qP
qP
qP
qP
qP
qP
qP
qP
qP
Rc
qz
nk
CI
nk
nk
sk
qP
qP
io
"}
(27,1,1) = {"
io
qP
qP
qz
nk
nk
nk
nk
qz
qP
qP
qP
qP
io
io
ps
io
io
qP
qP
qP
qz
nk
qK
nk
nk
qz
qP
qP
io
"}
(28,1,1) = {"
io
qP
qP
qz
gq
nk
nk
yj
qz
qP
qP
qP
qP
qU
lx
qP
lx
qU
qP
qP
qP
qz
nk
nk
nk
gq
qz
qP
qP
io
"}
(29,1,1) = {"
io
vW
qP
qz
nk
nk
nk
nk
qz
qP
qP
qP
qP
qU
qP
qP
gy
qU
qP
qP
qP
qz
nk
nk
VI
nk
qz
qP
vW
io
"}
(30,1,1) = {"
io
io
io
io
io
io
io
io
io
io
io
io
io
io
qP
me
qP
io
io
io
io
io
io
io
io
io
io
io
io
io
"}

(1,1,2) = {"
Hp
Hp
Hp
Hp
Hp
Hp
Hp
Hp
UD
zo
zo
zo
zo
zo
wS
zI
ky
zo
zo
zo
zo
zo
UD
Hp
Hp
Hp
Hp
Hp
Hp
Hp
"}
(2,1,2) = {"
Hp
Hp
Hp
Hp
Hp
Hp
Hp
Hp
zo
zo
zo
zo
Gx
Wl
zI
zI
zI
Wl
zo
zo
zo
zo
zo
Hp
Hp
Hp
Hp
Hp
Hp
Hp
"}
(3,1,2) = {"
Hp
Hp
Hp
Hp
Hp
Hp
Hp
Hp
zo
UD
UD
UD
bG
zI
zI
On
zI
zI
td
UD
UD
UD
zo
Hp
Hp
Hp
Hp
Hp
Hp
Hp
"}
(4,1,2) = {"
Hp
Hp
Hp
Hp
Hp
Hp
Hp
Hp
zo
UD
UD
UD
vU
zI
SM
gN
DE
zI
Zp
UD
UD
UD
zo
Hp
Hp
Hp
Hp
Hp
Hp
Hp
"}
(5,1,2) = {"
Hp
Hp
Hp
Hp
Hp
Hp
Hp
Hp
zo
zo
zo
zo
zo
Et
Et
Et
Et
Et
zo
zo
zo
zo
zo
Hp
Hp
Hp
Hp
Hp
Hp
Hp
"}
(6,1,2) = {"
Hp
Hp
Hp
Hp
Hp
Hp
Hp
Hp
Hp
Hp
Hp
Hp
NA
Rz
Rz
Rz
Rz
Rz
NA
Hp
Hp
Hp
Hp
Hp
Hp
Hp
Hp
Hp
Hp
Hp
"}
(7,1,2) = {"
Hp
Hp
Hp
Hp
Hp
Hp
Hp
Hp
Hp
Hp
Hp
Hp
Hp
Rz
Rz
Rz
Rz
Rz
Hp
Hp
Hp
Hp
Hp
Hp
Hp
Hp
Hp
Hp
Hp
Hp
"}
(8,1,2) = {"
Hp
Hp
Hp
Hp
Hp
Hp
Hp
Hp
Hp
Hp
Hp
Hp
Hp
Hp
Hp
Hp
Hp
Hp
Hp
Hp
Hp
Hp
Hp
Hp
Hp
Hp
Hp
Hp
Hp
Hp
"}
(9,1,2) = {"
Hp
Hp
Hp
Hp
Hp
Hp
Hp
Hp
Hp
Hp
Hp
Hp
Hp
Hp
Hp
Hp
Hp
Hp
Hp
Hp
Hp
Hp
Hp
Hp
Hp
Hp
Hp
Hp
Hp
Hp
"}
(10,1,2) = {"
Hp
Hp
Hp
Hp
Hp
Hp
Hp
Hp
Hp
Hp
Hp
Hp
Hp
Hp
Hp
Hp
Hp
Hp
Hp
Hp
Hp
Hp
Hp
Hp
Hp
Hp
Hp
Hp
Hp
Hp
"}
(11,1,2) = {"
Hp
Hp
Hp
Hp
Hp
Hp
Hp
Hp
Hp
Hp
Hp
Hp
Hp
Hp
Hp
Hp
Hp
Hp
Hp
Hp
Hp
Hp
Hp
Hp
Hp
Hp
Hp
Hp
Hp
Hp
"}
(12,1,2) = {"
Hp
Hp
Hp
Hp
Hp
Hp
Hp
Hp
Hp
Hp
Hp
Hp
Hp
Hp
Hp
Hp
Hp
Hp
Hp
Hp
Hp
Hp
Hp
Hp
Hp
Hp
Hp
Hp
Hp
Hp
"}
(13,1,2) = {"
Hp
Hp
Hp
Fs
Hp
Hp
Hp
Hp
Hp
Hp
Hp
Hp
Hp
Hp
Hp
Hp
Hp
Hp
Hp
Hp
Hp
Hp
Hp
Hp
Hp
Hp
Fs
Hp
Hp
Hp
"}
(14,1,2) = {"
qL
Yf
uZ
Rz
Hp
Hp
Hp
Hp
Hp
Hp
Hp
Hp
Hp
Hp
Hp
Hp
Hp
Hp
Hp
Hp
Hp
Hp
Hp
Hp
Hp
Hp
Rz
iK
Yf
qL
"}
(15,1,2) = {"
Rz
Rz
cn
Rz
Hp
Hp
Hp
Hp
Hp
Hp
Hp
Hp
Hp
Hp
Hp
Hp
Hp
Hp
Hp
Hp
Hp
Hp
Hp
Hp
Hp
Hp
Rz
jZ
Rz
Rz
"}
(16,1,2) = {"
Dj
BV
CL
Rz
Hp
Hp
Hp
Hp
Hp
Hp
Hp
Hp
Hp
Hp
Hp
Hp
Hp
Hp
Hp
Hp
Hp
Hp
Hp
Hp
Hp
Hp
Rz
hy
hg
Dj
"}
(17,1,2) = {"
io
Rz
QU
ji
Hp
Hp
Hp
Hp
Hp
Hp
Hp
Hp
Hp
Hp
Hp
Hp
Hp
Hp
Hp
Hp
Hp
Hp
Hp
Hp
Hp
Hp
qL
zz
Rz
io
"}
(18,1,2) = {"
io
hg
zp
CL
as
Hp
Hp
Hp
Hp
Hp
Hp
Hp
Hp
Hp
Hp
Hp
Hp
Hp
Hp
Hp
Hp
Hp
Hp
Hp
Hp
Fs
MG
hg
hg
io
"}
(19,1,2) = {"
io
Rz
Rz
Rz
cn
Hp
Hp
Hp
Hp
Hp
Hp
Hp
Hp
Hp
Hp
Hp
Hp
Hp
Hp
Hp
Hp
Hp
Hp
Hp
Hp
jZ
Rz
Rz
Rz
io
"}
(20,1,2) = {"
io
hg
BV
hg
cn
Hp
Hp
Hp
Hp
Hp
Hp
Hp
Hp
Hp
Hp
Hp
Hp
Hp
Hp
Hp
Hp
Hp
Hp
Hp
Hp
jZ
hg
hg
hg
io
"}
(21,1,2) = {"
io
Rz
Rz
Rz
QU
ji
Hp
Hp
Hp
Hp
Hp
Hp
Hp
Hp
Hp
Hp
Hp
Hp
Hp
Hp
Hp
Hp
Hp
Hp
kE
zz
Rz
Rz
Rz
io
"}
(22,1,2) = {"
io
hg
hg
BV
Rz
CF
Hp
Hp
Hp
Hp
Hp
Hp
Hp
Hp
Hp
Hp
Hp
Hp
Hp
Hp
Hp
Hp
Hp
Hp
hy
Rz
BV
hg
hg
io
"}
(23,1,2) = {"
io
mH
Rz
Rz
Rz
QU
qL
as
Hp
Hp
Hp
Hp
Hp
Hp
Hp
Hp
Hp
Hp
Hp
Hp
Hp
Hp
Fs
nJ
zz
Rz
Rz
Rz
Rz
Fn
"}
(24,1,2) = {"
io
Rz
hg
BV
Rz
hg
BV
LH
ji
Hp
Hp
Hp
Hp
Hp
Hp
Hp
Hp
Hp
Hp
Hp
Hp
kE
XB
hg
zp
Rz
hg
BV
Rz
io
"}
(25,1,2) = {"
io
Rz
Rz
Rz
Rz
Rz
Rz
Rz
QU
qL
qL
qL
xH
Rz
Rz
Rz
Rz
xH
qL
qL
qL
zz
Rz
Rz
Rz
Rz
Rz
Rz
Rz
io
"}
(26,1,2) = {"
io
Rz
Rz
Rz
Rz
hg
hg
sR
zp
BV
hg
hg
Rz
Rz
Rz
Rz
Rz
Rz
BV
hg
hg
hg
sR
BV
hg
Rz
Rz
Rz
Rz
io
"}
(27,1,2) = {"
io
Rz
Rz
Rz
Rz
Rz
Rz
Rz
Rz
Rz
Rz
Rz
Rz
Rz
Rz
Rz
Rz
Rz
Rz
Rz
Rz
Rz
Rz
Rz
Rz
Rz
Rz
Rz
Rz
io
"}
(28,1,2) = {"
io
Rz
bf
Qm
Rz
fI
ex
Rz
Rz
sp
ar
Rz
Rz
Rz
Rz
Rz
Rz
Rz
Rz
Rg
Ni
Rz
Rz
WX
ar
Rz
fI
fI
Rz
io
"}
(29,1,2) = {"
io
io
Rz
Rz
Dj
Rz
Rz
Rz
Rz
Rz
Rz
Rz
Dj
Rz
Rz
Rz
Rz
Rz
Dj
Rz
Rz
Rz
Rz
Rz
Rz
Dj
Rz
Rz
io
io
"}
(30,1,2) = {"
io
io
io
io
io
io
io
io
io
io
io
io
io
Rz
Rz
Rz
Rz
Rz
io
io
io
io
io
io
io
io
io
io
io
io
"}
