//MAP CONVERTED BY dmm2tgm.py THIS HEADER COMMENT PREVENTS RECONVERSION, DO NOT REMOVE
"a" = (
/turf/closed/wall/mineral/wood,
/area/template_noop)
"c" = (
/obj/structure/sign/property_for_sale,
/turf/open/floor/grass,
/area/template_noop)
"d" = (
/turf/open/floor/grass,
/area/template_noop)
"h" = (
/obj/structure/fluff/railing/tall{
	dir = 8
	},
/obj/structure/soil,
/turf/open/floor/dirt,
/area/template_noop)
"k" = (
/turf/closed/wall/mineral/roofwall/center,
/area/template_noop)
"p" = (
/turf/open/floor/rooftop{
	dir = 4
	},
/area/template_noop)
"u" = (
/obj/structure/fluff/railing/tall,
/turf/open/floor/grass,
/area/template_noop)
"w" = (
/turf/open/floor/rooftop{
	dir = 8
	},
/area/template_noop)
"B" = (
/obj/structure/well,
/turf/open/floor/grass,
/area/template_noop)
"E" = (
/obj/structure/window/openclose,
/turf/open/floor/wood,
/area/template_noop)
"M" = (
/obj/structure/door/fancy,
/turf/open/floor/wood,
/area/template_noop)
"N" = (
/turf/closed/wall/mineral/roofwall/middle{
	dir = 4
	},
/area/template_noop)
"Q" = (
/obj/structure/fluff/railing/tall{
	dir = 10
	},
/obj/structure/soil,
/turf/open/floor/dirt,
/area/template_noop)
"R" = (
/turf/template_noop,
/area/template_noop)
"U" = (
/turf/open/transparent/openspace,
/area/template_noop)
"X" = (
/turf/open/floor/wood,
/area/template_noop)
"Y" = (
/obj/structure/window/openclose{
	dir = 8
	},
/turf/open/floor/wood,
/area/template_noop)
"Z" = (
/turf/closed/wall/mineral/roofwall/middle{
	dir = 8
	},
/area/template_noop)

(1,1,1) = {"
d
d
d
d
c
a
Y
a
M
a
Y
a
h
h
h
h
Q
"}
(2,1,1) = {"
d
d
d
d
d
a
X
X
X
X
X
E
d
d
d
d
u
"}
(3,1,1) = {"
d
d
d
d
d
a
X
X
X
X
X
a
B
d
d
d
u
"}
(4,1,1) = {"
a
a
a
a
a
a
X
X
X
X
X
a
a
a
M
a
a
"}
(5,1,1) = {"
a
X
X
X
X
X
X
X
X
X
X
X
X
X
X
X
a
"}
(6,1,1) = {"
a
X
X
X
X
X
X
X
X
X
X
X
X
X
X
X
a
"}
(7,1,1) = {"
a
X
X
X
X
X
X
X
X
X
X
X
X
X
X
X
a
"}
(8,1,1) = {"
a
X
X
X
X
X
X
X
X
X
X
X
X
X
X
X
a
"}
(9,1,1) = {"
a
X
X
X
X
X
X
X
X
X
X
X
X
X
X
X
a
"}
(10,1,1) = {"
a
a
a
a
X
X
X
X
X
X
X
X
X
a
a
a
a
"}
(11,1,1) = {"
R
R
R
a
X
X
X
X
X
X
X
X
X
a
R
R
R
"}
(12,1,1) = {"
R
R
R
a
X
X
X
X
X
X
X
X
X
a
R
R
R
"}
(13,1,1) = {"
R
R
R
a
a
a
X
X
X
X
X
a
a
a
R
R
R
"}
(14,1,1) = {"
R
R
R
R
R
a
a
X
X
X
a
a
R
R
R
R
R
"}
(15,1,1) = {"
R
R
R
R
R
R
a
a
a
a
a
R
R
R
R
R
R
"}

(1,1,2) = {"
U
U
U
U
U
w
w
w
w
w
w
w
U
U
U
U
U
"}
(2,1,2) = {"
U
U
U
U
U
w
w
w
w
w
w
w
U
U
U
U
U
"}
(3,1,2) = {"
U
U
U
U
U
w
w
w
w
w
w
w
U
U
U
U
U
"}
(4,1,2) = {"
w
w
w
w
w
w
w
w
w
w
w
w
w
w
w
w
w
"}
(5,1,2) = {"
Z
Z
Z
Z
Z
Z
Z
Z
Z
Z
Z
Z
Z
Z
Z
Z
Z
"}
(6,1,2) = {"
k
k
k
k
k
k
k
k
k
k
k
k
k
k
k
k
k
"}
(7,1,2) = {"
k
k
k
k
k
k
k
k
k
k
k
k
k
k
k
k
k
"}
(8,1,2) = {"
k
k
k
k
k
k
k
k
k
k
k
k
k
k
k
k
k
"}
(9,1,2) = {"
N
N
N
N
N
N
N
N
N
N
N
N
N
N
N
N
N
"}
(10,1,2) = {"
p
p
p
p
p
p
p
p
p
p
p
p
p
p
p
p
p
"}
(11,1,2) = {"
U
U
U
p
p
p
p
p
p
p
p
p
p
p
U
U
U
"}
(12,1,2) = {"
U
U
U
p
p
p
p
p
p
p
p
p
p
p
U
U
U
"}
(13,1,2) = {"
U
U
U
p
p
p
p
p
p
p
p
p
p
p
U
U
U
"}
(14,1,2) = {"
U
U
U
U
U
p
p
p
p
p
p
p
U
U
U
U
U
"}
(15,1,2) = {"
U
U
U
U
U
U
p
p
p
p
p
U
U
U
U
U
U
"}
