//MAP CONVERTED BY dmm2tgm.py THIS HEADER COMMENT PREVENTS RECONVERSION, DO NOT REMOVE
"a" = (
/obj/machinery/light/fueled/wallfire/candle/skull/r,
/turf/open/floor/herringbone,
/area/template_noop)
"b" = (
/obj/machinery/light/fueled/wallfire/candle/skull/r,
/obj/structure/fluff/walldeco/maidendrape,
/turf/open/floor/herringbone,
/area/template_noop)
"m" = (
/turf/closed/wall/mineral/underbrick,
/area/template_noop)
"z" = (
/obj/structure/circle_protection{
	name = null
	},
/obj/effect/building_node/spawning_grounds,
/turf/open/floor/herringbone,
/area/template_noop)
"N" = (
/obj/machinery/light/fueled/wallfire/candle/skull/l,
/obj/structure/fluff/walldeco/maidendrape,
/turf/open/floor/herringbone,
/area/template_noop)
"T" = (
/turf/open/floor/herringbone,
/area/template_noop)
"V" = (
/obj/machinery/light/fueled/wallfire/candle/skull/l,
/turf/open/floor/herringbone,
/area/template_noop)

(1,1,1) = {"
m
m
T
T
m
"}
(2,1,1) = {"
m
N
T
T
V
"}
(3,1,1) = {"
T
T
z
T
T
"}
(4,1,1) = {"
m
b
T
T
a
"}
(5,1,1) = {"
m
m
T
T
m
"}
