//MAP CONVERTED BY dmm2tgm.py THIS HEADER COMMENT PREVENTS RECONVERSION, DO NOT REMOVE
"f" = (
/turf/open/floor/herringbone,
/area/template_noop)
"r" = (
/obj/machinery/light/fueled/wallfire/candle/skull/l,
/obj/structure/lootable_structure/stockpile/fish_barrel{
	pixel_y = 9;
	pixel_x = -7
	},
/obj/structure/lootable_structure/stockpile/mining_cache{
	pixel_y = -2;
	pixel_x = -1
	},
/turf/open/floor/herringbone,
/area/template_noop)
"t" = (
/obj/structure/rack/shelf/biggest,
/turf/open/floor/herringbone,
/area/template_noop)
"z" = (
/obj/structure/table/wood/crafted,
/turf/open/floor/herringbone,
/area/template_noop)
"H" = (
/obj/effect/building_node/stockpile,
/turf/open/floor/herringbone,
/area/template_noop)
"N" = (
/obj/structure/closet/crate/chest/old_crate{
	anchored = 1
	},
/obj/structure/closet/crate/chest/old_crate{
	pixel_y = 9;
	anchored = 1
	},
/turf/open/floor/herringbone,
/area/template_noop)
"Q" = (
/turf/closed/wall/mineral/underbrick,
/area/template_noop)
"R" = (
/obj/structure/lootable_structure/stockpile/fish_barrel{
	pixel_y = 9;
	pixel_x = -6
	},
/obj/structure/lootable_structure/stockpile/grain_barrel{
	pixel_y = -3
	},
/obj/structure/lootable_structure/stockpile/mining_cache{
	pixel_y = -2;
	pixel_x = -11
	},
/turf/open/floor/herringbone,
/area/template_noop)
"U" = (
/obj/machinery/light/fueled/wallfire/candle/skull,
/turf/open/floor/herringbone,
/area/template_noop)

(1,1,1) = {"
Q
z
z
f
Q
"}
(2,1,1) = {"
t
f
f
f
t
"}
(3,1,1) = {"
t
f
f
f
t
"}
(4,1,1) = {"
t
f
H
f
t
"}
(5,1,1) = {"
Q
U
t
f
Q
"}
(6,1,1) = {"
R
f
t
f
r
"}
(7,1,1) = {"
N
f
t
f
f
"}
