//MAP CONVERTED BY dmm2tgm.py THIS HEADER COMMENT PREVENTS RECONVERSION, DO NOT REMOVE
"a" = (
/obj/structure/spider/stickyweb,
/turf/open/floor/churchmarble,
/area/rogue/outdoors/caves)
"c" = (
/turf/closed/wall/mineral/stonebrick/reddish,
/area/rogue/outdoors/caves)
"d" = (
/obj/structure/chair/bench/couchablack/r,
/turf/open/floor/churchmarble,
/area/rogue/outdoors/caves)
"f" = (
/obj/structure/fluff/walldeco/vinez/l,
/turf/closed/wall/mineral/stonebrick/reddish,
/area/rogue/outdoors/caves)
"g" = (
/obj/structure/fluff/walldeco/vinez/r,
/obj/machinery/light/fueled/wallfire/candle/blue/r,
/obj/item/instrument/flute,
/turf/open/floor/cobblerock/alt,
/area/rogue/outdoors/caves)
"i" = (
/obj/structure/fluff/walldeco/vinez/l,
/obj/structure/fluff/walldeco/vinez/r,
/obj/structure/mineral_door/wood/violet,
/turf/open/floor/cobblerock/alt,
/area/rogue/outdoors/caves)
"l" = (
/mob/living/simple_animal/hostile/retaliate/spider/mutated,
/turf/open/floor/churchmarble,
/area/rogue/outdoors/caves)
"m" = (
/obj/structure/fluff/walldeco/vinez/r,
/obj/structure/fluff/walldeco/vinez/l,
/obj/structure/mineral_door/wood/violet,
/turf/open/floor/cobblerock/alt,
/area/rogue/outdoors/caves)
"n" = (
/obj/structure/fluff/walldeco/vinez/l,
/obj/machinery/light/fueled/wallfire/candle/blue/l,
/turf/open/floor/cobblerock/alt,
/turf/open/floor/cobblerock/alt,
/area/rogue/outdoors/caves)
"o" = (
/obj/machinery/light/fueled/wallfire/candle/blue/l,
/turf/open/floor/cobblerock/alt,
/area/rogue/outdoors/caves)
"p" = (
/obj/structure/chair/bench/couchablack,
/turf/open/floor/churchmarble,
/area/rogue/outdoors/caves)
"q" = (
/obj/structure/mineral_door/wood/violet,
/obj/effect/dungeon_directional_helper/west,
/turf/open/floor/cobblerock/alt,
/area/rogue/outdoors/caves)
"s" = (
/obj/structure/fluff/walldeco/vinez/r,
/turf/closed/wall/mineral/stonebrick/reddish,
/area/rogue/outdoors/caves)
"t" = (
/turf/closed/wall/mineral/stone/moss,
/area/rogue/outdoors/caves)
"v" = (
/turf/open/floor/cobblerock/alt,
/area/rogue/outdoors/caves)
"w" = (
/obj/item/clothing/shirt/tunic/blue,
/obj/item/gem/blue,
/obj/item/clothing/shoes/boots,
/obj/item/clothing/neck/psycross/silver/malum_steel,
/obj/item/clothing/ring/silver/saffira,
/obj/item/storage/belt/leather/plaquesilver,
/obj/item/weapon/sword/rapier/silver,
/obj/item/clothing/head/hatblu,
/obj/item/clothing/cloak/raincloak/blue,
/obj/item/clothing/gloves/leather/black,
/mob/living/carbon/human/species/skeleton/npc/no_equipment,
/obj/effect/mapping_helpers/floor_clothing_equipper,
/turf/open/floor/cobblerock/alt,
/area/rogue/outdoors/caves)
"x" = (
/obj/structure/table/vtable,
/obj/item/clothing/gloves/rare/elfplate,
/obj/item/clothing/head/rare/elfplate,
/obj/item/weapon/knife/dagger/steel/dirk,
/obj/item/clothing/shirt/undershirt/webs,
/obj/item/clothing/pants/webs,
/obj/item/clothing/cloak/raincloak/purple,
/obj/item/clothing/neck/menears,
/obj/item/clothing/neck/mercmedal/anthrax,
/turf/open/floor/churchmarble,
/area/rogue/outdoors/caves)
"y" = (
/obj/structure/spider/stickyweb,
/obj/machinery/light/fueled/wallfire/candle/blue/l,
/turf/open/floor/churchmarble,
/area/rogue/outdoors/caves)
"z" = (
/turf/open/floor/churchmarble,
/area/rogue/outdoors/caves)
"B" = (
/obj/structure/mineral_door/wood/violet,
/obj/structure/spider/stickyweb,
/turf/open/floor/churchmarble,
/area/rogue/outdoors/caves)
"C" = (
/obj/structure/mineral_door/wood/violet,
/obj/effect/dungeon_directional_helper/east,
/turf/open/floor/cobblerock/alt,
/area/rogue/outdoors/caves)
"D" = (
/obj/machinery/light/fueled/wallfire/candle/blue/r,
/obj/effect/dungeon_directional_helper/north,
/turf/open/floor/cobblerock/alt,
/area/rogue/outdoors/caves)
"E" = (
/obj/effect/dungeon_directional_helper/south,
/turf/open/floor/cobblerock/alt,
/area/rogue/outdoors/caves)
"F" = (
/obj/structure/fluff/walldeco/vinez/r,
/obj/machinery/light/fueled/wallfire/candle/blue/r,
/turf/open/floor/cobblerock/alt,
/turf/open/floor/cobblerock/alt,
/area/rogue/outdoors/caves)
"I" = (
/obj/structure/chair/wood/alt/chair_noble,
/turf/open/floor/churchmarble,
/area/rogue/outdoors/caves)
"K" = (
/obj/structure/fluff/walldeco/vinez/l,
/obj/machinery/light/fueled/wallfire/candle/blue/l,
/obj/item/reagent_containers/glass/bottle/whitewine,
/turf/open/floor/cobblerock/alt,
/turf/open/floor/cobblerock/alt,
/area/rogue/outdoors/caves)
"O" = (
/obj/structure/fluff/statue/spider,
/turf/open/floor/churchmarble,
/area/rogue/outdoors/caves)
"R" = (
/obj/structure/well,
/obj/item/reagent_containers/glass/bucket/wooden,
/turf/open/floor/cobblerock/alt,
/area/rogue/outdoors/caves)
"S" = (
/obj/structure/spider/stickyweb,
/obj/machinery/light/fueled/wallfire/candle/blue/r,
/turf/open/floor/churchmarble,
/area/rogue/outdoors/caves)
"W" = (
/obj/structure/table/vtable/v2,
/obj/item/reagent_containers/glass/bottle/wine/sourwine,
/obj/item/candle/yellow/lit/infinite/strong/skull,
/obj/item/reagent_containers/glass/bottle/stronghealthpot,
/obj/item/coin/silver/pile/xylix,
/obj/item/needle,
/obj/item/natural/bundle/silk,
/obj/item/natural/cloth,
/obj/item/natural/cloth,
/obj/item/natural/cloth,
/turf/open/floor/churchmarble,
/area/rogue/outdoors/caves)
"Z" = (
/obj/structure/spider/stickyweb,
/mob/living/simple_animal/hostile/retaliate/spider/mutated,
/turf/open/floor/churchmarble,
/area/rogue/outdoors/caves)

(1,1,1) = {"
c
c
c
q
c
c
c
c
"}
(2,1,1) = {"
v
f
n
v
K
f
o
E
"}
(3,1,1) = {"
D
i
w
R
v
m
v
c
"}
(4,1,1) = {"
c
s
F
v
g
s
c
c
"}
(5,1,1) = {"
c
c
c
C
c
c
c
c
"}

(1,1,2) = {"
t
t
t
B
t
t
t
t
"}
(2,1,2) = {"
t
p
z
Z
y
z
a
B
"}
(3,1,2) = {"
t
d
a
O
l
a
x
t
"}
(4,1,2) = {"
B
Z
z
S
a
I
W
t
"}
(5,1,2) = {"
t
t
t
t
B
t
t
t
"}
