//MAP CONVERTED BY dmm2tgm.py THIS HEADER COMMENT PREVENTS RECONVERSION, DO NOT REMOVE
"aq" = (
/obj/item/reagent_containers/food/snacks/rotten/meat,
/turf/open/floor/dirt/road,
/area/rogue)
"cm" = (
/turf/open/floor/dirt/road,
/area/rogue)
"cA" = (
/turf/closed/wall/mineral/tent,
/area/rogue)
"do" = (
/turf/open/floor/herringbone,
/area/rogue)
"dJ" = (
/obj/item/reagent_containers/glass/bucket/pot,
/obj/structure/table/wood/plain,
/turf/open/floor/blocks,
/area/rogue)
"ex" = (
/obj/item/organ/brain,
/turf/open/floor/ruinedwood,
/area/rogue)
"eF" = (
/obj/effect/dungeon_directional_helper/north,
/turf/open/floor/cobblerock,
/area/rogue)
"fL" = (
/obj/structure/fermentation_keg/random/water,
/obj/item/reagent_containers/glass/bowl,
/turf/open/floor/cobble,
/area/rogue)
"hT" = (
/turf/open/floor/cobble,
/area/rogue)
"iu" = (
/obj/item/organ/heart,
/obj/effect/decal/cleanable/blood,
/turf/open/floor/dirt/road,
/area/rogue)
"iB" = (
/obj/machinery/light/fueled/hearth,
/turf/open/floor/blocks,
/area/rogue)
"iH" = (
/obj/structure/table/wood/plain,
/obj/item/weapon/knife/hunting{
	pixel_y = 3;
	pixel_x = -5
	},
/obj/item/reagent_containers/food/snacks/rotten/mince{
	pixel_x = 6;
	pixel_y = 8
	},
/obj/item/reagent_containers/food/snacks/meat/salami{
	pixel_y = -1;
	pixel_x = -5
	},
/obj/item/reagent_containers/food/snacks/hardtack{
	pixel_y = 7;
	pixel_x = 9
	},
/obj/item/reagent_containers/food/snacks/hardtack{
	pixel_y = 7;
	pixel_x = 9
	},
/turf/open/floor/blocks,
/area/rogue)
"iR" = (
/obj/effect/decal/cleanable/dirt/dust,
/turf/open/floor/cobble,
/area/rogue)
"jl" = (
/obj/item/reagent_containers/food/snacks/rotten/meat,
/obj/item/organ/heart,
/obj/effect/decal/cleanable/blood,
/turf/open/floor/ruinedwood,
/area/rogue)
"jK" = (
/turf/closed/mineral/bedrock,
/area/rogue)
"kI" = (
/obj/item/organ/brain,
/obj/effect/decal/cleanable/blood,
/turf/open/floor/ruinedwood,
/area/rogue)
"kW" = (
/turf/open/floor/blocks,
/area/rogue)
"lL" = (
/obj/item/restraints/legcuffs/beartrap/armed,
/obj/item/reagent_containers/food/snacks/pie/cooked/apple,
/turf/open/floor/ruinedwood,
/area/rogue)
"mK" = (
/turf/open/floor/ruinedwood,
/area/rogue)
"nE" = (
/obj/item/clothing/face/facemask/goldmask,
/turf/open/floor/ruinedwood,
/area/rogue)
"oE" = (
/obj/item/paper/scroll,
/obj/structure/table/wood/plain,
/obj/item/natural/feather,
/turf/open/floor/cobblerock,
/area/rogue)
"ro" = (
/obj/item/organ/tongue,
/turf/open/floor/herringbone,
/area/rogue)
"sF" = (
/turf/closed/wall/mineral/wooddark,
/area/rogue)
"ta" = (
/obj/structure/table/wood/plain,
/obj/item/natural/cloth,
/obj/item/natural/cloth{
	pixel_y = 5;
	pixel_x = -7
	},
/turf/open/floor/cobble,
/area/rogue)
"tA" = (
/obj/structure/table/wood/plain,
/obj/item/needle,
/turf/open/floor/cobble,
/area/rogue)
"tB" = (
/obj/effect/decal/cleanable/blood,
/turf/open/floor/cobblerock,
/area/rogue)
"tS" = (
/obj/effect/dungeon_directional_helper/east,
/turf/open/floor/dirt/road,
/area/rogue)
"uy" = (
/obj/item/reagent_containers/food/snacks/rotten/meat,
/obj/effect/decal/cleanable/blood,
/turf/open/floor/ruinedwood,
/area/rogue)
"vj" = (
/obj/item/reagent_containers/glass/bottle/beer,
/turf/open/floor/cobblerock,
/area/rogue)
"xI" = (
/obj/structure/closet/crate/chest/old_crate,
/obj/item/weapon/sword/rapier/silver,
/obj/item/clothing/armor/cuirass,
/obj/item/clothing/face/facemask,
/obj/item/organ/heart,
/obj/effect/decal/cleanable/blood,
/obj/item/reagent_containers/food/snacks/hardtack,
/turf/open/floor/herringbone,
/area/rogue)
"yd" = (
/obj/effect/dungeon_directional_helper/south,
/turf/open/floor/cobblerock,
/area/rogue)
"yu" = (
/obj/effect/decal/cleanable/blood/footprints{
	dir = 4
	},
/turf/open/floor/cobblerock,
/area/rogue)
"zE" = (
/obj/structure/barricade/rogue,
/obj/structure/barricade/rogue/crude,
/turf/open/floor/cobblerock,
/area/rogue)
"Bz" = (
/obj/effect/decal/cleanable/blood,
/mob/living/carbon/human/species/orc/tribal,
/turf/open/floor/dirt/road,
/area/rogue)
"Cf" = (
/obj/item/ingot/gold,
/turf/open/floor/ruinedwood,
/area/rogue)
"CL" = (
/obj/item/clothing/neck/psycross/silver,
/turf/open/floor/ruinedwood,
/area/rogue)
"Du" = (
/obj/item/organ/eyes,
/turf/open/floor/dirt/road,
/area/rogue)
"DW" = (
/obj/structure/bed/shit,
/mob/living/carbon/human/species/skeleton/npc/peasant,
/obj/effect/decal/cleanable/dirt/dust,
/obj/effect/decal/cleanable/blood,
/obj/effect/decal/cleanable/blood/gibs/old,
/turf/open/floor/blocks,
/area/rogue)
"EB" = (
/mob/living/carbon/human/species/skeleton/npc/warrior/skilled,
/obj/structure/bed/mediocre,
/obj/item/organ/eyes,
/obj/effect/decal/cleanable/blood,
/obj/effect/decal/cleanable/blood/gibs/old,
/turf/open/floor/herringbone,
/area/rogue)
"EE" = (
/obj/item/restraints/legcuffs/beartrap/armed,
/obj/item/ingot/gold,
/turf/open/floor/cobblerock,
/area/rogue)
"Gq" = (
/obj/effect/decal/cleanable/blood,
/turf/open/floor/dirt/road,
/area/rogue)
"HA" = (
/obj/effect/decal/cleanable/dirt/dust,
/turf/open/floor/blocks,
/area/rogue)
"KM" = (
/obj/structure/mineral_door/wood,
/turf/open/floor/cobblerock,
/area/rogue)
"KV" = (
/mob/living/carbon/human/species/skeleton/npc/peasant,
/obj/structure/bed/mediocre,
/obj/item/reagent_containers/food/snacks/hardtack,
/obj/effect/decal/cleanable/blood/gibs/old,
/turf/open/floor/cobble,
/area/rogue)
"Mt" = (
/obj/item/weapon/knife/dagger/silver,
/obj/item/natural/stone,
/obj/item/natural/stone{
	pixel_y = -6;
	pixel_x = 4
	},
/obj/item/natural/stone{
	pixel_y = -12;
	pixel_x = -7
	},
/obj/item/natural/stone{
	pixel_y = 4;
	pixel_x = -7
	},
/obj/item/natural/stone{
	pixel_y = 7;
	pixel_x = 11
	},
/obj/effect/decal/cleanable/blood,
/turf/open/floor/cobblerock,
/area/rogue)
"Mw" = (
/obj/effect/dungeon_directional_helper/west,
/turf/open/floor/dirt/road,
/area/rogue)
"Ng" = (
/obj/effect/decal/cleanable/blood,
/turf/open/floor/ruinedwood,
/area/rogue)
"Oj" = (
/mob/living/carbon/human/species/orc/tribal,
/turf/open/floor/dirt/road,
/area/rogue)
"OG" = (
/obj/item/organ/lungs,
/turf/open/floor/dirt/road,
/area/rogue)
"Pa" = (
/obj/effect/decal/cleanable/blood,
/mob/living/carbon/human/species/orc/tribal,
/turf/open/floor/ruinedwood,
/area/rogue)
"PO" = (
/turf/open/floor/cobblerock,
/area/rogue)
"QY" = (
/obj/effect/decal/cleanable/dirt/dust,
/obj/structure/bed/mediocre,
/turf/open/floor/cobble,
/area/rogue)
"Rl" = (
/obj/item/organ/lungs,
/turf/open/floor/ruinedwood,
/area/rogue)
"SU" = (
/obj/item/reagent_containers/glass/bottle,
/turf/open/floor/cobblerock,
/area/rogue)
"Wk" = (
/obj/effect/decal/cleanable/blood,
/turf/open/floor/herringbone,
/area/rogue)
"Wv" = (
/obj/structure/bed/shit,
/mob/living/carbon/human/species/skeleton/npc/peasant,
/turf/open/floor/cobblerock,
/area/rogue)

(1,1,1) = {"
jK
jK
jK
jK
jK
Mw
PO
jK
jK
jK
jK
jK
"}
(2,1,1) = {"
jK
tA
iR
hT
KM
PO
cm
jK
vj
SU
oE
jK
"}
(3,1,1) = {"
jK
ta
hT
fL
sF
cm
PO
jK
PO
PO
vj
jK
"}
(4,1,1) = {"
jK
QY
hT
KV
jK
PO
cm
jK
zE
Wv
Mt
jK
"}
(5,1,1) = {"
jK
jK
KM
jK
jK
cm
PO
sF
KM
sF
jK
jK
"}
(6,1,1) = {"
PO
cm
cm
PO
PO
cm
PO
PO
yu
cm
cm
PO
"}
(7,1,1) = {"
eF
PO
PO
cm
PO
PO
cm
PO
cm
cm
PO
yd
"}
(8,1,1) = {"
jK
jK
jK
jK
jK
PO
cm
sF
jK
jK
jK
jK
"}
(9,1,1) = {"
jK
dJ
iB
HA
sF
PO
PO
KM
Wk
cA
EB
jK
"}
(10,1,1) = {"
jK
DW
kW
kW
KM
cm
PO
jK
do
ro
Wk
jK
"}
(11,1,1) = {"
jK
iH
HA
kW
jK
cm
PO
jK
Wk
do
xI
jK
"}
(12,1,1) = {"
jK
jK
jK
jK
jK
tS
cm
jK
jK
jK
jK
jK
"}

(1,1,2) = {"
jK
jK
jK
jK
PO
PO
PO
PO
jK
jK
jK
jK
"}
(2,1,2) = {"
jK
Oj
uy
jK
jK
cm
cm
jK
jK
Du
Pa
jK
"}
(3,1,2) = {"
jK
kI
mK
cm
jK
PO
PO
jK
cm
cm
uy
jK
"}
(4,1,2) = {"
jK
jK
ex
cm
PO
PO
cm
PO
Ng
Du
jK
jK
"}
(5,1,2) = {"
PO
jK
jK
PO
mK
EE
mK
PO
Gq
jK
jK
cm
"}
(6,1,2) = {"
cm
cm
PO
cm
PO
mK
nE
lL
mK
PO
PO
PO
"}
(7,1,2) = {"
PO
PO
PO
PO
mK
mK
CL
mK
PO
PO
cm
PO
"}
(8,1,2) = {"
PO
jK
jK
cm
tB
Cf
PO
mK
cm
jK
jK
PO
"}
(9,1,2) = {"
jK
jK
Rl
cm
cm
PO
cm
cm
PO
Gq
jK
jK
"}
(10,1,2) = {"
jK
aq
Ng
cm
jK
PO
PO
jK
jl
mK
iu
jK
"}
(11,1,2) = {"
jK
Bz
OG
jK
jK
cm
PO
jK
jK
cm
Oj
jK
"}
(12,1,2) = {"
jK
jK
jK
jK
PO
PO
cm
PO
jK
jK
jK
jK
"}
