//MAP CONVERTED BY dmm2tgm.py THIS HEADER COMMENT PREVENTS RECONVERSION, DO NOT REMOVE
"a" = (
/turf/closed/wall/mineral/stonebrick{
	wallclimb = 1;
	climbdiff = 1
	},
/area/rogue/indoors/shelter)
"d" = (
/obj/structure/window/openclose{
	dir = 1
	},
/turf/open/floor/ruinedwood/turned/darker,
/area/rogue/indoors/shelter)
"e" = (
/turf/open/floor/ruinedwood/turned/darker,
/area/rogue/indoors/shelter)
"g" = (
/obj/structure/fluff/railing/border,
/turf/open/floor/ruinedwood/turned/darker,
/area/rogue/indoors/shelter)
"j" = (
/obj/structure/window/solid,
/obj/structure/bars,
/turf/open/floor/ruinedwood/turned,
/area/rogue/indoors/shelter)
"k" = (
/obj/structure/stairs{
	dir = 4
	},
/turf/open/floor/ruinedwood/turned/darker,
/area/rogue/indoors/shelter)
"l" = (
/obj/structure/chair/wood/alt,
/obj/effect/landmark/settlement_mob_spawn,
/turf/open/floor/ruinedwood/turned/darker,
/area/rogue/indoors/shelter)
"n" = (
/obj/structure/table/wood/crafted,
/turf/open/floor/ruinedwood/turned/darker,
/area/rogue/indoors/shelter)
"o" = (
/obj/structure/bookcase/random,
/turf/open/floor/ruinedwood/turned/darker,
/area/rogue/indoors/shelter)
"p" = (
/obj/structure/closet/crate/drawer,
/turf/open/floor/ruinedwood/turned/darker,
/area/rogue/indoors/shelter)
"r" = (
/obj/structure/chair/wood/alt{
	dir = 1
	},
/obj/effect/landmark/settlement_mob_spawn,
/turf/open/floor/ruinedwood/turned,
/area/rogue/indoors/shelter)
"s" = (
/obj/structure/fluff/railing/border{
	dir = 4
	},
/obj/structure/closet/crate/crafted_closet/inn,
/obj/item/broom,
/turf/open/floor/ruinedwood/turned/darker,
/area/rogue/indoors/shelter)
"t" = (
/obj/effect/landmark/settlement_mob_spawn,
/turf/open/floor/ruinedwood/turned/darker,
/area/rogue/indoors/shelter)
"u" = (
/obj/effect/landmark/settlement_road_node,
/turf/open/floor/ruinedwood/turned,
/area/rogue/indoors/shelter)
"v" = (
/obj/structure/bed/mediocre,
/obj/machinery/light/fueled/wallfire/candle/l,
/turf/open/floor/ruinedwood/turned/darker,
/area/rogue/indoors/shelter)
"y" = (
/turf/closed/wall/mineral/decowood,
/area/rogue/indoors/shelter)
"A" = (
/obj/structure/fluff/walldeco/vinez/blue,
/turf/closed/wall/mineral/stonebrick{
	wallclimb = 1;
	climbdiff = 1
	},
/area/rogue/indoors/shelter)
"C" = (
/obj/structure/window/openclose,
/turf/open/floor/ruinedwood/turned/darker,
/area/rogue/indoors/shelter)
"E" = (
/obj/effect/decal/carpet/kover_purple{
	pixel_x = 16;
	pixel_y = -2
	},
/turf/open/floor/ruinedwood/turned,
/area/rogue/indoors/shelter)
"I" = (
/turf/open/floor/ruinedwood/turned,
/area/rogue/indoors/shelter)
"K" = (
/obj/machinery/light/fueled/wallfire/candle,
/turf/open/floor/ruinedwood/turned,
/area/rogue/indoors/shelter)
"L" = (
/turf/closed/wall/mineral/wooddark,
/area/rogue/indoors/shelter)
"N" = (
/obj/effect/decal/carpet/kover_black{
	pixel_x = 15;
	pixel_y = -12
	},
/turf/open/floor/ruinedwood/turned/darker,
/area/rogue/indoors/shelter)
"O" = (
/obj/structure/fluff/railing/border,
/obj/structure/fluff/railing/border{
	dir = 6
	},
/turf/open/floor/ruinedwood/turned/darker,
/area/rogue/indoors/shelter)
"P" = (
/obj/machinery/light/fueled/wallfire/candle/r,
/turf/open/floor/ruinedwood/turned/darker,
/area/rogue/indoors/shelter)
"Q" = (
/turf/open/transparent/openspace,
/area/rogue/indoors/shelter)
"R" = (
/obj/machinery/light/fueled/wallfire{
	pixel_x = -32
	},
/obj/structure/table/wood/crafted,
/turf/open/floor/ruinedwood/turned,
/area/rogue/indoors/shelter)
"U" = (
/obj/machinery/light/fueled/wallfire/candle{
	pixel_y = -32
	},
/turf/open/floor/ruinedwood/turned/darker,
/area/rogue/indoors/shelter)
"V" = (
/obj/structure/fluff/railing/border{
	dir = 6
	},
/turf/open/floor/ruinedwood/turned/darker,
/area/rogue/indoors/shelter)
"Y" = (
/obj/machinery/light/fueled/hearth,
/obj/item/cooking/pan,
/turf/open/floor/ruinedwood/turned/darker,
/area/rogue/indoors/shelter)

(1,1,1) = {"
A
A
a
a
a
a
"}
(2,1,1) = {"
A
l
R
r
U
a
"}
(3,1,1) = {"
u
E
I
e
I
a
"}
(4,1,1) = {"
a
K
e
a
k
a
"}
(5,1,1) = {"
j
e
o
a
a
a
"}
(6,1,1) = {"
a
a
a
a
a
a
"}

(1,1,2) = {"
L
y
y
y
y
L
"}
(2,1,2) = {"
y
v
p
V
s
y
"}
(3,1,2) = {"
C
t
N
g
Q
y
"}
(4,1,2) = {"
y
Y
e
O
Q
d
"}
(5,1,2) = {"
y
n
e
P
k
y
"}
(6,1,2) = {"
L
y
y
y
y
L
"}
