//MAP CONVERTED BY dmm2tgm.py THIS HEADER COMMENT PREVENTS RECONVERSION, DO NOT REMOVE
"a" = (
/turf/open/floor/ruinedwood/turned/darker,
/area/rogue/indoors/shelter)
"c" = (
/obj/effect/landmark/settlement_road_node,
/turf/open/floor/ruinedwood/turned,
/area/rogue/indoors/shelter)
"d" = (
/turf/open/transparent/openspace,
/area/rogue/indoors/shelter)
"e" = (
/obj/structure/stairs{
	dir = 1
	},
/turf/open/floor/ruinedwood/turned,
/area/rogue/indoors/shelter)
"f" = (
/obj/structure/table/wood/crafted,
/obj/machinery/light/fueled/wallfire/candle,
/turf/open/floor/ruinedwood/turned/darker,
/area/rogue/indoors/shelter)
"h" = (
/obj/effect/landmark/settlement_mob_spawn,
/turf/open/floor/ruinedwood/turned/darker,
/area/rogue/indoors/shelter)
"j" = (
/obj/structure/stairs{
	dir = 1
	},
/turf/open/floor/ruinedwood/turned/darker,
/area/rogue/indoors/shelter)
"l" = (
/obj/structure/table/wood/crafted,
/turf/open/floor/ruinedwood/turned/darker,
/area/rogue/indoors/shelter)
"m" = (
/turf/closed/wall/mineral/wooddark,
/area/rogue/indoors/shelter)
"o" = (
/obj/structure/window/openclose{
	dir = 4
	},
/turf/open/floor/ruinedwood/turned/darker,
/area/rogue/indoors/shelter)
"p" = (
/obj/structure/window/solid,
/obj/structure/bars,
/turf/open/floor/ruinedwood/turned,
/area/rogue/indoors/shelter)
"q" = (
/obj/structure/fluff/railing/border{
	dir = 8
	},
/obj/structure/fluff/railing/border{
	dir = 9
	},
/turf/open/floor/ruinedwood/turned/darker,
/area/rogue/indoors/shelter)
"r" = (
/obj/structure/closet/crate/drawer,
/turf/open/floor/ruinedwood/turned/darker,
/area/rogue/indoors/shelter)
"s" = (
/obj/structure/fluff/walldeco/vinez/blue,
/turf/closed/wall/mineral/stonebrick{
	wallclimb = 1;
	climbdiff = 1
	},
/area/rogue/indoors/shelter)
"t" = (
/obj/machinery/light/fueled/hearth,
/obj/item/cooking/pan,
/obj/machinery/light/fueled/wallfire/candle/r,
/turf/open/floor/ruinedwood/turned/darker,
/area/rogue/indoors/shelter)
"w" = (
/turf/open/floor/ruinedwood/turned,
/area/rogue/indoors/shelter)
"y" = (
/obj/structure/fluff/railing/border{
	dir = 1
	},
/obj/structure/closet/crate/crafted_closet/inn,
/obj/item/broom,
/turf/open/floor/ruinedwood/turned/darker,
/area/rogue/indoors/shelter)
"z" = (
/obj/effect/decal/carpet/square{
	dir = 4;
	pixel_x = -6;
	pixel_y = 15
	},
/turf/open/floor/ruinedwood/turned/darker,
/area/rogue/indoors/shelter)
"E" = (
/obj/structure/bed/mediocre,
/turf/open/floor/ruinedwood/turned/darker,
/area/rogue/indoors/shelter)
"F" = (
/obj/structure/window/openclose{
	dir = 1
	},
/turf/open/floor/ruinedwood/turned/darker,
/area/rogue/indoors/shelter)
"G" = (
/turf/closed/wall/mineral/stonebrick{
	wallclimb = 1;
	climbdiff = 1
	},
/area/rogue/indoors/shelter)
"I" = (
/obj/machinery/light/fueled/wallfire/candle{
	pixel_y = -32
	},
/obj/effect/landmark/settlement_mob_spawn,
/turf/open/floor/ruinedwood/turned/darker,
/area/rogue/indoors/shelter)
"J" = (
/obj/structure/bookcase/random,
/turf/open/floor/ruinedwood/turned/darker,
/area/rogue/indoors/shelter)
"N" = (
/turf/closed/wall/mineral/decowood,
/area/rogue/indoors/shelter)
"Q" = (
/obj/structure/fluff/walldeco/vinez/blue{
	dir = 5
	},
/turf/closed/wall/mineral/stonebrick{
	wallclimb = 1;
	climbdiff = 1
	},
/area/rogue/indoors/shelter)
"S" = (
/obj/structure/fluff/railing/border{
	dir = 8
	},
/obj/effect/decal/carpet/square{
	dir = 4;
	pixel_x = 27;
	pixel_y = 15
	},
/turf/open/floor/ruinedwood/turned/darker,
/area/rogue/indoors/shelter)
"T" = (
/obj/machinery/light/fueled/wallfire/candle/l,
/turf/open/transparent/openspace,
/area/rogue/indoors/shelter)
"V" = (
/obj/structure/fluff/railing/border{
	dir = 9
	},
/turf/open/floor/ruinedwood/turned/darker,
/area/rogue/indoors/shelter)
"X" = (
/obj/item/reagent_containers/food/snacks/smallrat,
/turf/open/floor/ruinedwood/turned,
/area/rogue/indoors/shelter)
"Y" = (
/obj/machinery/light/fueled/wallfire{
	pixel_y = 31
	},
/obj/structure/chair/wood/alt{
	dir = 4
	},
/obj/effect/landmark/settlement_mob_spawn,
/turf/open/floor/ruinedwood/turned/darker,
/area/rogue/indoors/shelter)

(1,1,1) = {"
s
s
G
G
G
G
"}
(2,1,1) = {"
G
G
e
w
J
G
"}
(3,1,1) = {"
G
G
G
w
I
G
"}
(4,1,1) = {"
G
Y
a
X
w
p
"}
(5,1,1) = {"
G
f
w
z
h
G
"}
(6,1,1) = {"
s
Q
c
G
p
G
"}

(1,1,2) = {"
m
N
o
N
N
m
"}
(2,1,2) = {"
N
j
d
T
y
N
"}
(3,1,2) = {"
N
a
q
S
V
N
"}
(4,1,2) = {"
N
a
a
a
E
F
"}
(5,1,2) = {"
N
t
l
a
r
N
"}
(6,1,2) = {"
m
N
N
N
N
m
"}
