//MAP CONVERTED BY dmm2tgm.py THIS HEADER COMMENT PREVENTS RECONVERSION, DO NOT REMOVE
"a" = (
/obj/structure/fluff/walldeco/vinez/blue,
/turf/closed/wall/mineral/stonebrick{
	wallclimb = 1;
	climbdiff = 1
	},
/area/rogue/indoors/shelter)
"b" = (
/obj/structure/stairs,
/turf/open/floor/ruinedwood/turned/darker,
/area/rogue/indoors/shelter)
"c" = (
/obj/structure/window/openclose,
/turf/open/floor/ruinedwood/turned/darker,
/area/rogue/indoors/shelter)
"d" = (
/obj/structure/fluff/railing/border{
	dir = 6
	},
/turf/open/floor/ruinedwood/turned/darker,
/area/rogue/indoors/shelter)
"e" = (
/obj/machinery/light/fueled/wallfire/candle/r,
/turf/open/floor/ruinedwood/turned/darker,
/area/rogue/indoors/shelter)
"f" = (
/obj/effect/landmark/settlement_road_node,
/turf/open/floor/ruinedwood/turned,
/area/rogue/indoors/shelter)
"i" = (
/obj/effect/decal/carpet/square{
	dir = 4;
	pixel_x = -6;
	pixel_y = 15
	},
/turf/open/floor/ruinedwood/turned/darker,
/area/rogue/indoors/shelter)
"j" = (
/obj/structure/window/openclose{
	dir = 1
	},
/turf/open/floor/ruinedwood/turned/darker,
/area/rogue/indoors/shelter)
"n" = (
/obj/structure/table/wood/crafted,
/turf/open/floor/ruinedwood/turned/darker,
/area/rogue/indoors/shelter)
"o" = (
/turf/open/transparent/openspace,
/area/rogue/indoors/shelter)
"p" = (
/obj/item/reagent_containers/food/snacks/smallrat,
/turf/open/floor/ruinedwood/turned,
/area/rogue/indoors/shelter)
"q" = (
/obj/structure/chair/wood/alt{
	dir = 1
	},
/turf/open/floor/ruinedwood/turned/darker,
/area/rogue/indoors/shelter)
"r" = (
/obj/structure/stairs,
/obj/machinery/light/fueled/wallfire/candle/r,
/turf/open/floor/ruinedwood/turned/darker,
/area/rogue/indoors/shelter)
"t" = (
/obj/structure/closet/crate/crafted_closet/inn,
/obj/item/broom,
/turf/open/floor/ruinedwood/turned/darker,
/area/rogue/indoors/shelter)
"v" = (
/obj/structure/table/vtable/v2,
/turf/open/floor/ruinedwood/turned/darker,
/area/rogue/indoors/shelter)
"w" = (
/obj/structure/fluff/railing/border,
/turf/open/floor/ruinedwood/turned/darker,
/area/rogue/indoors/shelter)
"x" = (
/obj/machinery/light/fueled/wallfire{
	pixel_x = -32
	},
/obj/structure/table/wood/crafted,
/turf/open/floor/ruinedwood/turned,
/area/rogue/indoors/shelter)
"y" = (
/obj/machinery/light/fueled/hearth,
/obj/item/cooking/pan,
/turf/open/floor/ruinedwood/turned,
/area/rogue/indoors/shelter)
"z" = (
/obj/structure/window/solid,
/obj/structure/bars,
/turf/open/floor/ruinedwood/turned,
/area/rogue/indoors/shelter)
"B" = (
/turf/closed/wall/mineral/wooddark,
/area/rogue/indoors/shelter)
"C" = (
/obj/structure/bookcase/random,
/turf/open/floor/ruinedwood/turned,
/area/rogue/indoors/shelter)
"D" = (
/turf/closed/wall/mineral/decowood,
/area/rogue/indoors/shelter)
"E" = (
/turf/closed/wall/mineral/stonebrick{
	wallclimb = 1;
	climbdiff = 1
	},
/area/rogue/indoors/shelter)
"H" = (
/obj/structure/closet/crate/drawer,
/turf/open/floor/ruinedwood/turned/darker,
/area/rogue/indoors/shelter)
"I" = (
/turf/open/floor/ruinedwood/turned,
/area/rogue/indoors/shelter)
"K" = (
/obj/effect/decal/carpet/kover_black{
	dir = 1;
	pixel_y = -3
	},
/turf/open/floor/ruinedwood/turned/darker,
/area/rogue/indoors/shelter)
"L" = (
/obj/structure/chair/wood/alt,
/turf/open/floor/ruinedwood/turned/darker,
/area/rogue/indoors/shelter)
"M" = (
/obj/structure/bookcase/random,
/turf/open/floor/ruinedwood/turned/darker,
/area/rogue/indoors/shelter)
"O" = (
/obj/structure/table/vtable,
/turf/open/floor/ruinedwood/turned/darker,
/area/rogue/indoors/shelter)
"P" = (
/obj/machinery/light/fueled/wallfire/candle/l,
/turf/open/floor/ruinedwood/turned/darker,
/area/rogue/indoors/shelter)
"Q" = (
/obj/machinery/light/fueled/wallfire/candle{
	pixel_y = -32
	},
/obj/effect/landmark/settlement_mob_spawn,
/turf/open/floor/ruinedwood/turned/darker,
/area/rogue/indoors/shelter)
"R" = (
/obj/effect/landmark/settlement_mob_spawn,
/turf/open/floor/ruinedwood/turned/darker,
/area/rogue/indoors/shelter)
"T" = (
/obj/structure/fluff/railing/border{
	dir = 4
	},
/obj/structure/fluff/railing/border{
	dir = 6
	},
/turf/open/floor/ruinedwood/turned/darker,
/area/rogue/indoors/shelter)
"U" = (
/obj/machinery/light/fueled/wallfire/candle,
/turf/open/floor/ruinedwood/turned,
/area/rogue/indoors/shelter)
"W" = (
/turf/open/floor/ruinedwood/turned/darker,
/area/rogue/indoors/shelter)
"Y" = (
/obj/structure/fluff/railing/border{
	dir = 4
	},
/turf/open/floor/ruinedwood/turned/darker,
/area/rogue/indoors/shelter)
"Z" = (
/obj/structure/bed/mediocre,
/turf/open/floor/ruinedwood/turned/darker,
/area/rogue/indoors/shelter)

(1,1,1) = {"
E
E
E
E
E
E
E
"}
(2,1,1) = {"
E
W
L
x
q
Q
E
"}
(3,1,1) = {"
f
K
W
W
I
p
E
"}
(4,1,1) = {"
E
U
W
W
n
y
E
"}
(5,1,1) = {"
z
I
p
I
E
E
E
"}
(6,1,1) = {"
E
C
I
R
b
E
a
"}
(7,1,1) = {"
E
E
E
E
E
a
a
"}

(1,1,2) = {"
B
D
D
B
D
D
B
"}
(2,1,2) = {"
D
t
R
P
M
M
D
"}
(3,1,2) = {"
D
Z
W
W
L
O
j
"}
(4,1,2) = {"
B
H
W
W
i
v
B
"}
(5,1,2) = {"
c
W
d
Y
T
W
D
"}
(6,1,2) = {"
D
e
w
o
o
r
D
"}
(7,1,2) = {"
B
D
D
B
D
D
B
"}
