//MAP CONVERTED BY dmm2tgm.py THIS HEADER COMMENT PREVENTS RECONVERSION, DO NOT REMOVE
"a" = (
/turf/closed/wall/mineral/decowood,
/area/rogue/indoors/shelter)
"e" = (
/obj/structure/bed/mediocre,
/obj/effect/landmark/settlement_mob_spawn,
/turf/open/floor/ruinedwood/turned/darker,
/area/rogue/indoors/shelter)
"g" = (
/obj/structure/fluff/railing/border{
	dir = 10
	},
/turf/open/floor/ruinedwood/turned/darker,
/area/rogue/indoors/shelter)
"h" = (
/obj/effect/landmark/settlement_mob_spawn,
/turf/open/floor/ruinedwood/turned,
/area/rogue/indoors/shelter)
"i" = (
/obj/structure/fluff/railing/border{
	dir = 8
	},
/turf/open/floor/ruinedwood/turned/darker,
/area/rogue/indoors/shelter)
"k" = (
/obj/structure/table/wood/crafted,
/turf/open/floor/ruinedwood/turned/darker,
/area/rogue/indoors/shelter)
"l" = (
/obj/effect/landmark/settlement_road_node,
/turf/open/floor/ruinedwood/turned,
/area/rogue/indoors/shelter)
"m" = (
/obj/structure/closet/crate/drawer,
/obj/machinery/light/fueled/wallfire/candle/r,
/turf/open/floor/ruinedwood/turned/darker,
/area/rogue/indoors/shelter)
"o" = (
/obj/structure/window/solid,
/obj/structure/bars,
/turf/open/floor/ruinedwood/turned,
/area/rogue/indoors/shelter)
"p" = (
/obj/structure/window/openclose{
	dir = 8
	},
/turf/open/floor/ruinedwood/turned/darker,
/area/rogue/indoors/shelter)
"q" = (
/turf/open/floor/ruinedwood/turned/darker,
/area/rogue/indoors/shelter)
"r" = (
/obj/structure/fluff/walldeco/vinez/blue,
/turf/closed/wall/mineral/stonebrick{
	wallclimb = 1;
	climbdiff = 1
	},
/area/rogue/indoors/shelter)
"t" = (
/turf/open/floor/ruinedwood/turned,
/area/rogue/indoors/shelter)
"u" = (
/obj/structure/bookcase/random,
/turf/open/floor/ruinedwood/turned/darker,
/area/rogue/indoors/shelter)
"v" = (
/obj/machinery/light/fueled/wallfire/candle,
/turf/open/floor/ruinedwood/turned,
/area/rogue/indoors/shelter)
"w" = (
/obj/structure/fluff/railing/border{
	dir = 8
	},
/obj/structure/fluff/railing/border{
	dir = 10
	},
/turf/open/floor/ruinedwood/turned/darker,
/area/rogue/indoors/shelter)
"y" = (
/obj/structure/stairs,
/turf/open/floor/ruinedwood/turned/darker,
/area/rogue/indoors/shelter)
"z" = (
/obj/structure/fluff/walldeco/vinez/blue{
	dir = 10
	},
/turf/closed/wall/mineral/stonebrick{
	wallclimb = 1;
	climbdiff = 1
	},
/area/rogue/indoors/shelter)
"B" = (
/obj/effect/decal/carpet{
	dir = 4;
	pixel_x = 3;
	pixel_y = 2
	},
/turf/open/floor/ruinedwood/turned/darker,
/area/rogue/indoors/shelter)
"D" = (
/obj/structure/closet/crate/crafted_closet/inn,
/obj/item/broom,
/turf/open/floor/ruinedwood/turned/darker,
/area/rogue/indoors/shelter)
"E" = (
/turf/open/transparent/openspace,
/area/rogue/indoors/shelter)
"F" = (
/turf/closed/wall/mineral/stonebrick{
	wallclimb = 1;
	climbdiff = 1
	},
/area/rogue/indoors/shelter)
"G" = (
/obj/effect/decal/carpet/kover_purple{
	dir = 4;
	pixel_x = 16;
	pixel_y = 19
	},
/turf/open/floor/ruinedwood/turned/darker,
/area/rogue/indoors/shelter)
"L" = (
/obj/structure/chair/wood/alt{
	dir = 8
	},
/turf/open/floor/ruinedwood/turned/darker,
/area/rogue/indoors/shelter)
"M" = (
/obj/machinery/light/fueled/wallfire{
	pixel_x = -32
	},
/turf/open/floor/ruinedwood/turned,
/area/rogue/indoors/shelter)
"N" = (
/obj/structure/fluff/railing/border,
/turf/open/floor/ruinedwood/turned/darker,
/area/rogue/indoors/shelter)
"O" = (
/obj/effect/landmark/settlement_mob_spawn,
/turf/open/floor/ruinedwood/turned/darker,
/area/rogue/indoors/shelter)
"P" = (
/obj/machinery/light/fueled/hearth,
/obj/item/cooking/pan,
/obj/machinery/light/fueled/wallfire/candle/r,
/turf/open/floor/ruinedwood/turned/darker,
/area/rogue/indoors/shelter)
"Q" = (
/obj/structure/table/wood/crafted,
/obj/machinery/light/fueled/wallfire/candle{
	pixel_y = -32
	},
/turf/open/floor/ruinedwood/turned,
/area/rogue/indoors/shelter)
"R" = (
/turf/closed/wall/mineral/wooddark,
/area/rogue/indoors/shelter)
"V" = (
/obj/machinery/light/fueled/wallfire/candle/l,
/turf/open/transparent/openspace,
/area/rogue/indoors/shelter)
"X" = (
/obj/structure/chair/wood/alt{
	dir = 4
	},
/turf/open/floor/ruinedwood/turned/darker,
/area/rogue/indoors/shelter)
"Y" = (
/obj/structure/fluff/walldeco/vinez/blue{
	dir = 5
	},
/turf/closed/wall/mineral/stonebrick{
	wallclimb = 1;
	climbdiff = 1
	},
/area/rogue/indoors/shelter)
"Z" = (
/obj/structure/window/openclose,
/turf/open/floor/ruinedwood/turned/darker,
/area/rogue/indoors/shelter)

(1,1,1) = {"
r
F
F
F
F
r
r
"}
(2,1,1) = {"
Y
u
M
q
y
F
r
"}
(3,1,1) = {"
o
q
t
t
F
F
F
"}
(4,1,1) = {"
F
v
q
q
q
X
F
"}
(5,1,1) = {"
o
q
t
t
t
Q
F
"}
(6,1,1) = {"
r
q
B
t
h
L
F
"}
(7,1,1) = {"
r
Y
l
F
o
z
z
"}

(1,1,2) = {"
R
a
a
R
a
a
R
"}
(2,1,2) = {"
a
q
N
V
E
y
a
"}
(3,1,2) = {"
a
O
g
i
w
q
a
"}
(4,1,2) = {"
R
D
q
q
G
q
R
"}
(5,1,2) = {"
a
e
q
q
q
O
a
"}
(6,1,2) = {"
Z
m
q
q
k
P
a
"}
(7,1,2) = {"
R
a
p
R
a
a
R
"}
