//MAP CONVERTED BY dmm2tgm.py THIS HEADER COMMENT PREVENTS RECONVERSION, DO NOT REMOVE
"bm" = (
/obj/structure/chair/wood/alt{
	dir = 8
	},
/turf/open/floor/carpet/red,
/area/rogue/indoors/shelter)
"ds" = (
/obj/structure/window/openclose{
	dir = 1
	},
/obj/structure/curtain/bounty,
/obj/structure/bars,
/turf/open/floor/ruinedwood,
/area/rogue/indoors/shelter)
"dM" = (
/turf/open/floor/tile/kitchen,
/area/rogue/indoors/shelter)
"et" = (
/obj/structure/bookcase/random/legends,
/turf/open/floor/carpet/red,
/area/rogue/indoors/shelter)
"eE" = (
/obj/machinery/light/fueled/wallfire/candle/r,
/turf/open/floor/ruinedwood/darker,
/area/rogue/indoors/shelter)
"gE" = (
/obj/structure/chair/wood/alt,
/turf/open/floor/carpet/red,
/area/rogue/indoors/shelter)
"hu" = (
/obj/structure/bookcase/random/thesis,
/turf/open/floor/ruinedwood/darker,
/area/rogue/indoors/shelter)
"hJ" = (
/obj/structure/fluff/walldeco/bigpainting/lake{
	pixel_x = 0
	},
/turf/open/floor/ruinedwood/darker,
/area/rogue/indoors/shelter)
"iG" = (
/obj/structure/fluff/railing/border,
/obj/structure/fluff/railing/border{
	dir = 8
	},
/obj/structure/fluff/railing/border{
	dir = 10
	},
/turf/open/floor/ruinedwood/darker,
/area/rogue/indoors/shelter)
"jj" = (
/obj/structure/chair/wood/alt{
	dir = 8
	},
/obj/effect/landmark/settlement_mob_spawn,
/turf/open/floor/carpet/red,
/area/rogue/indoors/shelter)
"jm" = (
/turf/closed/wall/mineral/wooddark/horizontal,
/area/rogue/indoors/shelter)
"md" = (
/turf/closed/wall/mineral/decowood,
/area/rogue/indoors/shelter)
"mh" = (
/obj/structure/stairs{
	dir = 8
	},
/turf/open/floor/ruinedwood,
/area/rogue/indoors/shelter)
"mo" = (
/obj/structure/stairs{
	dir = 8
	},
/turf/open/floor/ruinedwood/darker,
/area/rogue/indoors/shelter)
"mX" = (
/obj/structure/chair/stool,
/turf/open/floor/ruinedwood/darker,
/area/rogue/indoors/shelter)
"nN" = (
/obj/structure/fluff/railing/border{
	dir = 5
	},
/turf/open/floor/ruinedwood/darker,
/area/rogue/indoors/shelter)
"pH" = (
/obj/effect/landmark/settlement_road_node,
/turf/open/floor/ruinedwood/darker,
/area/rogue/indoors/shelter)
"qv" = (
/obj/structure/fluff/railing/border{
	dir = 6
	},
/obj/structure/fluff/walldeco/painting/crown{
	pixel_x = -32
	},
/turf/open/floor/ruinedwood/darker,
/area/rogue/indoors/shelter)
"rx" = (
/obj/structure/chair/wood/alt{
	dir = 4
	},
/obj/machinery/light/fueled/wallfire/candle/l,
/turf/open/floor/carpet/red,
/area/rogue/indoors/shelter)
"tN" = (
/obj/machinery/light/fueled/wallfire/big_fireplace{
	pixel_x = -16;
	pixel_y = 32
	},
/turf/open/floor/carpet/red,
/area/rogue/indoors/shelter)
"vA" = (
/turf/closed/wall/mineral/stonebrick{
	wallclimb = 1;
	climbdiff = 1
	},
/area/rogue/indoors/shelter)
"wI" = (
/obj/structure/table/wood/reinf_long,
/obj/structure/ladder{
	layer = 2.7
	},
/obj/item/reagent_containers/glass/cup/silver,
/turf/open/floor/carpet/red,
/area/rogue/indoors/shelter)
"xI" = (
/obj/structure/fluff/railing/border,
/obj/structure/fluff/railing/border{
	dir = 4
	},
/obj/structure/fluff/railing/border{
	dir = 6
	},
/obj/structure/closet/crate/drawer{
	pixel_x = -3;
	pixel_y = 7
	},
/turf/open/floor/ruinedwood,
/area/rogue/indoors/shelter)
"yO" = (
/obj/machinery/light/fueled/wallfire/candle/l,
/turf/open/floor/ruinedwood,
/area/rogue/indoors/shelter)
"zd" = (
/obj/machinery/light/fueled/wallfire/candle,
/obj/effect/landmark/settlement_mob_spawn,
/turf/open/floor/ruinedwood,
/area/rogue/indoors/shelter)
"zP" = (
/obj/effect/landmark/settlement_mob_spawn,
/turf/open/floor/ruinedwood,
/area/rogue/indoors/shelter)
"Am" = (
/obj/structure/fluff/railing/border{
	dir = 1
	},
/turf/open/floor/ruinedwood,
/area/rogue/indoors/shelter)
"Ce" = (
/obj/effect/decal/carpet,
/turf/open/floor/ruinedwood,
/area/rogue/indoors/shelter)
"Cp" = (
/turf/open/floor/carpet/red,
/area/rogue/indoors/shelter)
"CY" = (
/obj/structure/fluff/railing/border{
	dir = 10
	},
/obj/structure/mirror{
	pixel_x = 33;
	pixel_y = 0
	},
/obj/effect/landmark/settlement_mob_spawn,
/turf/open/floor/ruinedwood/darker,
/area/rogue/indoors/shelter)
"DH" = (
/obj/structure/chair/stool,
/turf/open/floor/ruinedwood,
/area/rogue/indoors/shelter)
"Ei" = (
/obj/structure/bed/inn,
/obj/item/bedsheet/fabric,
/obj/machinery/light/fueled/wallfire/candle,
/turf/open/floor/ruinedwood,
/area/rogue/indoors/shelter)
"EZ" = (
/obj/structure/table/vtable/v2,
/obj/machinery/light/fueled/wallfire/candle/r,
/turf/open/floor/carpet/red,
/area/rogue/indoors/shelter)
"Gl" = (
/obj/structure/bookcase/random_recipes,
/turf/open/floor/ruinedwood/darker,
/area/rogue/indoors/shelter)
"GC" = (
/obj/structure/table/wood/plain,
/obj/structure/fluff/millstone{
	pixel_x = 5;
	pixel_y = 13
	},
/obj/item/reagent_containers/food/snacks/produce/grain/wheat,
/obj/item/reagent_containers/food/snacks/produce/grain/wheat,
/obj/item/reagent_containers/food/snacks/produce/grain/wheat,
/obj/item/reagent_containers/food/snacks/produce/grain/wheat,
/obj/item/reagent_containers/food/snacks/produce/grain/wheat,
/turf/open/floor/tile/kitchen,
/area/rogue/indoors/shelter)
"Hi" = (
/obj/structure/fermentation_keg/water,
/obj/machinery/light/fueled/wallfire/candle/r,
/turf/open/floor/ruinedwood,
/area/rogue/indoors/shelter)
"Hj" = (
/obj/structure/table/wood/reinf_long{
	dir = 4
	},
/obj/item/reagent_containers/glass/cup/wooden{
	pixel_x = -5
	},
/obj/item/reagent_containers/glass/cup/wooden{
	pixel_x = 9;
	pixel_y = 6
	},
/turf/open/floor/tile/kitchen,
/area/rogue/indoors/shelter)
"Hw" = (
/obj/structure/table/wood/plain,
/obj/item/reagent_containers/glass/bowl{
	pixel_x = 9;
	pixel_y = 7
	},
/obj/item/reagent_containers/glass/bowl{
	pixel_x = -7;
	pixel_y = -12
	},
/turf/open/floor/tile/kitchen,
/area/rogue/indoors/shelter)
"Id" = (
/obj/structure/table/wood/reinf_long{
	dir = 1
	},
/obj/item/reagent_containers/glass/carafe/silver/redwine{
	pixel_x = 4;
	pixel_y = -1
	},
/obj/item/reagent_containers/glass/cup/silver{
	pixel_x = -8;
	pixel_y = 2
	},
/turf/open/floor/carpet/red,
/area/rogue/indoors/shelter)
"Js" = (
/turf/closed/wall/mineral/wooddark,
/area/rogue/indoors/shelter)
"JV" = (
/obj/structure/window/openclose{
	dir = 8
	},
/obj/structure/curtain/bounty,
/obj/structure/bars,
/turf/open/floor/ruinedwood,
/area/rogue/indoors/shelter)
"LX" = (
/obj/structure/window/openclose{
	dir = 4
	},
/obj/structure/curtain/bounty,
/turf/open/floor/ruinedwood,
/area/rogue/indoors/shelter)
"Nd" = (
/obj/structure/table/wood/reinf_long{
	dir = 8
	},
/obj/item/kitchen/rollingpin{
	pixel_x = -4;
	pixel_y = 6
	},
/obj/item/weapon/knife/villager{
	pixel_x = 9;
	pixel_y = 1
	},
/turf/open/floor/tile/kitchen,
/area/rogue/indoors/shelter)
"Ne" = (
/obj/structure/closet/crate/crafted_closet/inn/south,
/obj/item/clothing/armor/leather/splint,
/obj/item/weapon/pitchfork,
/turf/open/floor/ruinedwood,
/area/rogue/indoors/shelter)
"Nh" = (
/turf/open/floor/ruinedwood,
/area/rogue/indoors/shelter)
"NS" = (
/obj/structure/table/vtable,
/turf/open/floor/carpet/red,
/area/rogue/indoors/shelter)
"NX" = (
/obj/effect/landmark/settlement_mob_spawn,
/turf/open/floor/tile/kitchen,
/area/rogue/indoors/shelter)
"QK" = (
/obj/effect/landmark/settlement_mob_spawn,
/turf/open/floor/ruinedwood/darker,
/area/rogue/indoors/shelter)
"SA" = (
/obj/machinery/light/fueled/hearth,
/obj/machinery/light/fueled/oven{
	pixel_y = 32
	},
/obj/item/reagent_containers/glass/bucket/pot,
/turf/open/floor/tile/kitchen,
/area/rogue/indoors/shelter)
"Tq" = (
/obj/structure/stairs{
	dir = 1
	},
/turf/open/floor/ruinedwood,
/area/rogue/indoors/shelter)
"Tu" = (
/obj/machinery/light/fueled/hearth,
/obj/machinery/light/fueled/oven{
	pixel_y = 32
	},
/obj/item/cooking/pan,
/turf/open/floor/tile/kitchen,
/area/rogue/indoors/shelter)
"UD" = (
/obj/machinery/light/fueled/wallfire/big_fireplace{
	pixel_y = 32
	},
/obj/effect/decal/carpet/square{
	pixel_x = 15
	},
/turf/open/floor/ruinedwood/darker,
/area/rogue/indoors/shelter)
"Vp" = (
/obj/machinery/light/fueled/wallfire/candle,
/turf/open/floor/ruinedwood,
/area/rogue/indoors/shelter)
"VL" = (
/turf/open/floor/ruinedwood/darker,
/area/rogue/indoors/shelter)
"VR" = (
/turf/open/transparent/openspace,
/area/rogue/indoors/shelter)
"XI" = (
/obj/structure/chair/wood/alt{
	dir = 4
	},
/obj/effect/landmark/settlement_mob_spawn,
/turf/open/floor/carpet/red,
/area/rogue/indoors/shelter)
"XS" = (
/turf/closed/wall/mineral/wooddark/vertical,
/area/rogue/indoors/shelter)
"Zj" = (
/obj/structure/window/solid,
/obj/structure/curtain/bounty,
/obj/structure/bars,
/turf/open/floor/ruinedwood/darker,
/area/rogue/indoors/shelter)

(1,1,1) = {"
Js
jm
jm
Js
Zj
Zj
jm
Js
"}
(2,1,1) = {"
jm
vA
vA
vA
Nh
XI
rx
jm
"}
(3,1,1) = {"
jm
vA
vA
vA
tN
Id
wI
Zj
"}
(4,1,1) = {"
Js
mh
mo
Js
Nh
bm
jj
Zj
"}
(5,1,1) = {"
vA
hJ
Nh
VL
Nh
Nh
VL
Js
"}
(6,1,1) = {"
vA
VL
VL
Nh
VL
Nh
Ce
pH
"}
(7,1,1) = {"
Js
XS
XS
Js
Vp
Nh
Nh
Js
"}
(8,1,1) = {"
vA
Tu
dM
dM
Nh
Nh
VL
Zj
"}
(9,1,1) = {"
vA
SA
NX
Nd
DH
VL
Nh
Zj
"}
(10,1,1) = {"
jm
GC
Hw
Hj
mX
VL
Hi
jm
"}
(11,1,1) = {"
Js
jm
jm
jm
Zj
Zj
jm
Js
"}

(1,1,2) = {"
Js
md
Js
LX
LX
Js
md
Js
"}
(2,1,2) = {"
md
zd
VL
nN
Nh
Nh
QK
md
"}
(3,1,2) = {"
md
mh
mo
Am
Nh
eE
VL
md
"}
(4,1,2) = {"
Js
VR
VR
Js
XS
Js
VL
Js
"}
(5,1,2) = {"
md
VR
VR
jm
hu
yO
VL
ds
"}
(6,1,2) = {"
md
XS
XS
Js
Gl
VL
Nh
ds
"}
(7,1,2) = {"
md
Ne
qv
xI
VL
VL
zP
ds
"}
(8,1,2) = {"
Js
UD
Nh
Tq
VL
Nh
et
Js
"}
(9,1,2) = {"
md
Nh
VL
Tq
zP
Cp
NS
md
"}
(10,1,2) = {"
md
Ei
CY
iG
Nh
gE
EZ
md
"}
(11,1,2) = {"
Js
md
Js
JV
JV
Js
md
Js
"}
