//MAP CONVERTED BY dmm2tgm.py THIS HEADER COMMENT PREVENTS RECONVERSION, DO NOT REMOVE
"al" = (
/obj/structure/door/violet,
/turf/open/floor/ruinedwood,
/area/rogue/outdoors/bog)
"aZ" = (
/obj/structure/chair/bench/church/smallbench,
/mob/living/carbon/human/species/skeleton/npc/peasant,
/turf/open/floor/herringbone,
/area/rogue/outdoors/bog)
"bA" = (
/obj/structure/flora/grass/water/reeds,
/turf/open/water/cleanshallow,
/area/rogue/outdoors/bog)
"cB" = (
/obj/structure/flora/grass,
/turf/open/floor/dirt/road,
/area/rogue/outdoors/bog)
"cM" = (
/obj/structure/bed/hay,
/turf/open/floor/ruinedwood/chevron,
/area/rogue/outdoors/bog)
"cP" = (
/obj/structure/flora/tree,
/turf/open/floor/grass,
/area/rogue/outdoors/bog)
"df" = (
/turf/open/floor/blocks,
/area/rogue/outdoors/bog)
"dy" = (
/obj/item/restraints/legcuffs/beartrap/armed/camouflage,
/obj/structure/flora/grass,
/turf/open/floor/dirt/road,
/area/rogue/outdoors/bog)
"dN" = (
/obj/structure/fluff/walldeco/psybanner/red{
	pixel_y = 32
	},
/turf/open/floor/herringbone,
/area/rogue/outdoors/bog)
"fC" = (
/obj/item/restraints/legcuffs/beartrap/armed/camouflage,
/turf/open/floor/dirt/road,
/area/rogue/outdoors/bog)
"fE" = (
/turf/open/floor/grass,
/area/rogue/outdoors/bog)
"gz" = (
/obj/structure/flora/grass,
/turf/open/floor/grass,
/area/rogue/outdoors/bog)
"gS" = (
/obj/structure/table/church{
	dir = 1
	},
/obj/item/clothing/neck/psycross/silver,
/turf/open/floor/blocks,
/area/rogue/outdoors/bog)
"hB" = (
/turf/open/water/cleanshallow,
/area/rogue/outdoors/bog)
"ld" = (
/obj/structure/bars/cemetery,
/turf/open/floor/dirt/road,
/area/rogue/outdoors/bog)
"lL" = (
/turf/open/water/swamp,
/area/rogue/outdoors/bog)
"mr" = (
/obj/structure/fluff/statue/gargoyle/moss,
/turf/open/floor/dirt/road,
/area/rogue/outdoors/bog)
"mE" = (
/mob/living/carbon/human/species/skeleton/npc/warrior/skilled,
/turf/open/floor/ruinedwood/spiral,
/area/rogue/outdoors/bog)
"nA" = (
/obj/structure/fermentation_keg/random/water,
/turf/open/floor/ruinedwood/chevron,
/area/rogue/outdoors/bog)
"nW" = (
/turf/open/floor/ruinedwood/spiral,
/area/rogue/outdoors/bog)
"rt" = (
/obj/structure/chair/bench/church/smallbench,
/turf/open/floor/herringbone,
/area/rogue/outdoors/bog)
"rC" = (
/obj/structure/fluff/psycross/crafted,
/turf/open/floor/dirt/road,
/area/rogue/outdoors/bog)
"rJ" = (
/mob/living/carbon/human/species/skeleton/npc/peasant,
/turf/open/floor/cobble/mossy,
/area/rogue/outdoors/bog)
"rL" = (
/obj/structure/bed/hay,
/mob/living/carbon/human/species/skeleton/npc/peasant,
/turf/open/floor/ruinedwood/chevron,
/area/rogue/outdoors/bog)
"rR" = (
/turf/open/floor/blocks/green,
/area/rogue/outdoors/bog)
"sa" = (
/mob/living/carbon/human/species/skeleton/npc/peasant,
/turf/open/floor/dirt/road,
/area/rogue/outdoors/bog)
"sl" = (
/obj/structure/flora/ausbushes/ppflowers,
/turf/open/floor/grass,
/area/rogue/outdoors/bog)
"sA" = (
/obj/structure/flora/tree,
/turf/open/floor/dirt/road,
/area/rogue/outdoors/bog)
"ty" = (
/turf/open/floor/herringbone,
/area/rogue/outdoors/bog)
"uB" = (
/obj/structure/fluff/statue/gargoyle/moss,
/turf/open/floor/grass,
/area/rogue/outdoors/bog)
"uC" = (
/obj/structure/fluff/railing/tall/palisade{
	dir = 1
	},
/obj/structure/fluff/railing/tall/palisade{
	dir = 8
	},
/turf/open/floor/dirt/road,
/area/rogue/outdoors/bog)
"uZ" = (
/turf/open/floor/blocks/paving,
/area/rogue/outdoors/bog)
"vG" = (
/obj/structure/closet/crate/coffin,
/obj/item/clothing/shirt/robe/necra,
/obj/item/clothing/head/padded/deathshroud,
/turf/open/floor/blocks,
/area/rogue/outdoors/bog)
"wa" = (
/obj/structure/fluff/psycross,
/turf/open/floor/ruinedwood/turned/alt{
	dir = 1
	},
/area/rogue/outdoors/bog)
"wi" = (
/obj/item/coin/copper,
/turf/open/water/cleanshallow,
/area/rogue/outdoors/bog)
"wK" = (
/obj/structure/fluff/railing/tall/palisade{
	dir = 1
	},
/turf/open/floor/dirt/road,
/area/rogue/outdoors/bog)
"xI" = (
/obj/structure/fluff/walldeco/psybanner/red{
	pixel_y = 32
	},
/turf/open/floor/blocks,
/area/rogue/outdoors/bog)
"xJ" = (
/obj/structure/flora/ausbushes/ywflowers,
/turf/open/floor/grass,
/area/rogue/outdoors/bog)
"Aa" = (
/obj/structure/door/iron/bars,
/turf/open/floor/blocks,
/area/rogue/outdoors/bog)
"Al" = (
/obj/effect/spawner/map_spawner/grass_low,
/turf/open/floor/grass,
/area/rogue/outdoors/bog)
"An" = (
/mob/living/carbon/human/species/skeleton/npc/warrior/skilled,
/turf/open/floor/cobble/mossy,
/area/rogue/outdoors/bog)
"Av" = (
/obj/machinery/light/fueled/firebowl/standing/blue,
/turf/open/floor/grass,
/area/rogue/outdoors/bog)
"AT" = (
/obj/structure/fluff/railing/tall/palisade{
	dir = 4
	},
/turf/open/floor/dirt/road,
/area/rogue/outdoors/bog)
"AX" = (
/obj/machinery/light/fueled/firebowl/standing/blue,
/turf/open/floor/herringbone,
/area/rogue/outdoors/bog)
"BI" = (
/obj/structure/fluff/railing/tall/palisade{
	dir = 4
	},
/obj/structure/fluff/railing/tall/palisade{
	dir = 1
	},
/turf/open/floor/dirt/road,
/area/rogue/outdoors/bog)
"BQ" = (
/turf/open/floor/hexstone,
/area/rogue/outdoors/bog)
"Ci" = (
/turf/closed/wall/mineral/craftstone,
/area/rogue/outdoors/bog)
"CW" = (
/obj/structure/table/church,
/obj/item/clothing/head/helmet/heavy/necked/necra,
/turf/open/floor/blocks,
/area/rogue/outdoors/bog)
"CZ" = (
/obj/structure/fluff/railing/tall/palisade{
	dir = 1
	},
/turf/open/floor/grass,
/area/rogue/outdoors/bog)
"Dp" = (
/obj/structure/well/fountain,
/turf/open/floor/hexstone,
/area/rogue/outdoors/bog)
"Dr" = (
/obj/structure/chair/bench/church/smallbench,
/mob/living/carbon/human/species/skeleton/npc/peasant,
/turf/open/floor/blocks,
/area/rogue/outdoors/bog)
"Gs" = (
/obj/structure/door/weak/bolt,
/obj/effect/mapping_helpers/access/locker,
/turf/open/floor/cobble/mossy,
/area/rogue/outdoors/bog)
"GU" = (
/obj/structure/chair/bench/church/smallbench,
/mob/living/carbon/human/species/skeleton/npc/peasant,
/turf/open/floor/ruinedwood/spiral,
/area/rogue/outdoors/bog)
"HR" = (
/obj/structure/fluff/statue/psy,
/turf/open/floor/blocks/green,
/area/rogue/outdoors/bog)
"Id" = (
/mob/living/carbon/human/species/skeleton/npc/warrior/skilled,
/turf/open/floor/blocks/paving,
/area/rogue/outdoors/bog)
"Ix" = (
/obj/structure/flora/ausbushes/brflowers,
/turf/open/floor/grass,
/area/rogue/outdoors/bog)
"IL" = (
/obj/structure/chair/bench/ancientlog,
/turf/open/floor/dirt/road,
/area/rogue/outdoors/bog)
"Jt" = (
/obj/structure/door/violet,
/turf/open/floor/hexstone,
/area/rogue/outdoors/bog)
"MK" = (
/obj/structure/table/wood/plain,
/obj/item/natural/cloth,
/turf/open/floor/ruinedwood/chevron,
/area/rogue/outdoors/bog)
"Og" = (
/obj/structure/closet/crate/coffin,
/obj/item/coin/silver,
/turf/open/floor/blocks/paving,
/area/rogue/outdoors/bog)
"OE" = (
/obj/structure/fluff/railing/tall/palisade{
	dir = 8
	},
/obj/structure/fluff/railing/tall/palisade{
	dir = 1
	},
/turf/open/floor/dirt/road,
/area/rogue/outdoors/bog)
"OM" = (
/obj/structure/table/wood/plain,
/turf/open/floor/ruinedwood/chevron,
/area/rogue/outdoors/bog)
"ON" = (
/obj/structure/closet/crate/coffin,
/obj/item/clothing/neck/psycross/silver/necra,
/turf/open/floor/blocks,
/area/rogue/outdoors/bog)
"OQ" = (
/obj/structure/chair/bench/church/smallbench,
/turf/open/floor/blocks,
/area/rogue/outdoors/bog)
"Pw" = (
/obj/structure/fluff/railing/tall/palisade{
	dir = 1
	},
/obj/structure/fluff/railing/tall/palisade{
	dir = 4
	},
/turf/open/floor/dirt/road,
/area/rogue/outdoors/bog)
"PC" = (
/obj/structure/fluff/railing/tall/palisade{
	dir = 8
	},
/turf/open/floor/dirt/road,
/area/rogue/outdoors/bog)
"Qk" = (
/obj/structure/bars/cemetery,
/turf/open/floor/blocks,
/area/rogue/outdoors/bog)
"Rb" = (
/obj/structure/stairs/stone{
	dir = 4
	},
/turf/open/floor/blocks/paving,
/area/rogue/outdoors/bog)
"Rk" = (
/turf/open/floor/dirt/road,
/area/rogue/outdoors/bog)
"Rs" = (
/obj/structure/fluff/psycross,
/turf/open/floor/ruinedwood/spiral,
/area/rogue/outdoors/bog)
"Sf" = (
/turf/open/floor/cobble/mossy,
/area/rogue/outdoors/bog)
"Tp" = (
/turf/open/floor/dirt,
/area/rogue/outdoors/bog)
"Tt" = (
/obj/structure/table/church/m,
/turf/open/floor/ruinedwood/spiral,
/area/rogue/outdoors/bog)
"UI" = (
/obj/structure/chair/bench/church/smallbench,
/turf/open/floor/ruinedwood/spiral,
/area/rogue/outdoors/bog)
"Vj" = (
/turf/open/floor/ruinedwood/turned/alt{
	dir = 1
	},
/area/rogue/outdoors/bog)
"Wk" = (
/obj/structure/door/iron/bars,
/turf/open/floor/cobble/mossy,
/area/rogue/outdoors/bog)
"Wo" = (
/obj/structure/closet/crate/coffin,
/obj/item/clothing/neck/psycross/silver/noc,
/turf/open/floor/blocks/paving,
/area/rogue/outdoors/bog)
"WF" = (
/obj/structure/bars/cemetery,
/turf/open/floor/cobble/mossy,
/area/rogue/outdoors/bog)
"WP" = (
/obj/structure/flora/grass/maneater/real,
/turf/open/floor/dirt/road,
/area/rogue/outdoors/bog)
"YA" = (
/obj/structure/closet/crate/coffin,
/obj/item/clothing/neck/psycross/silver/ravox,
/turf/open/floor/blocks/paving,
/area/rogue/outdoors/bog)

(1,1,1) = {"
Rk
Rk
Rk
Rk
Rk
Rk
Rk
Rk
Rk
Rk
Rk
Rk
Rk
Rk
Rk
Rk
Rk
Rk
Rk
Rk
Rk
Rk
Rk
Rk
lL
Rk
Rk
Rk
Rk
Rk
Rk
Rk
Rk
Rk
Rk
Rk
Rk
lL
Rk
Rk
"}
(2,1,1) = {"
Rk
Rk
Rk
Rk
Rk
Rk
Rk
Rk
Rk
Rk
Rk
Rk
lL
lL
lL
lL
lL
Rk
Rk
Rk
lL
lL
Rk
Rk
Rk
lL
lL
Rk
Rk
Rk
Rk
lL
lL
lL
Rk
Rk
Rk
lL
Rk
Rk
"}
(3,1,1) = {"
Rk
Rk
lL
lL
Rk
lL
lL
lL
lL
lL
lL
lL
lL
Rk
Rk
lL
lL
lL
Rk
Rk
Rk
lL
lL
lL
lL
lL
lL
lL
lL
lL
lL
lL
Rk
Rk
Rk
Rk
Rk
lL
Rk
Rk
"}
(4,1,1) = {"
Rk
lL
Rk
Rk
Rk
Rk
Rk
Rk
Rk
Rk
Rk
Rk
Rk
Rk
Rk
Rk
Rk
Rk
Rk
Rk
Rk
Rk
Rk
Rk
Rk
Rk
Rk
Rk
Rk
lL
lL
Rk
Rk
Rk
Rk
Rk
Rk
lL
lL
lL
"}
(5,1,1) = {"
Rk
lL
Rk
uC
PC
PC
PC
PC
PC
PC
PC
PC
PC
PC
PC
PC
PC
PC
PC
PC
PC
PC
PC
PC
PC
PC
PC
PC
PC
PC
PC
PC
PC
PC
PC
PC
OE
lL
lL
Rk
"}
(6,1,1) = {"
Rk
Rk
Rk
wK
Rk
Rk
Rk
Rk
Rk
Rk
Rk
Rk
Rk
Rk
Rk
Rk
Rk
Rk
Rk
Rk
Rk
Rk
Rk
Rk
Rk
Rk
Rk
Rk
Rk
Rk
Rk
Rk
Rk
Rk
Rk
Rk
wK
Rk
lL
Rk
"}
(7,1,1) = {"
Rk
Rk
Rk
wK
Rk
Rk
Rk
Rk
lL
Rk
Rk
Rk
lL
lL
lL
Rk
Rk
Rk
Rk
Rk
Rk
Rk
Rk
fE
Rk
fE
gz
wi
hB
hB
hB
bA
hB
hB
fE
Rk
wK
Rk
lL
Rk
"}
(8,1,1) = {"
Rk
lL
Rk
wK
Rk
lL
Rk
Rk
lL
lL
Rk
lL
lL
lL
lL
Ci
Ci
Ci
Ci
Ci
Ci
Rk
Rk
cP
fE
hB
hB
hB
wi
fE
Rk
hB
hB
wi
gz
Rk
wK
lL
lL
Rk
"}
(9,1,1) = {"
Rk
lL
Rk
wK
lL
lL
Rk
Rk
Rk
lL
Rk
lL
lL
lL
lL
Ci
cM
MK
OM
cM
Ci
fE
Rk
Rk
Rk
hB
bA
Rk
Al
BQ
fE
wi
hB
hB
hB
Rk
wK
lL
Rk
lL
"}
(10,1,1) = {"
Rk
lL
Rk
wK
lL
Rk
Rk
sA
Rk
Rk
lL
lL
lL
Ci
Ci
Ci
nW
nW
nW
nW
Ci
fE
sA
Rk
hB
wi
hB
Rk
BQ
Dp
BQ
gz
Al
hB
wi
cB
wK
lL
Rk
Rk
"}
(11,1,1) = {"
lL
lL
Rk
wK
lL
Rk
Rk
Rk
Rk
Rk
Rk
Rk
Rk
Ci
cM
nW
nW
nW
nW
nW
Ci
fE
Rk
cB
hB
hB
Al
gz
BQ
BQ
BQ
Al
Rk
hB
bA
Rk
wK
lL
Rk
lL
"}
(12,1,1) = {"
lL
Rk
Rk
wK
lL
Rk
Rk
Rk
Tp
lL
lL
Rk
Rk
Ci
OM
nW
nW
Rs
nW
nW
Ci
fE
fE
Rk
Rk
hB
hB
Al
hB
BQ
hB
Rk
hB
hB
Rk
Rk
wK
lL
Rk
lL
"}
(13,1,1) = {"
lL
Rk
Rk
wK
Rk
Rk
sA
Tp
lL
lL
lL
Rk
cB
Ci
cM
nW
nW
nW
nW
nW
Ci
Rk
rC
Rk
fE
bA
hB
hB
hB
hB
hB
hB
wi
hB
Rk
sA
CZ
Rk
lL
lL
"}
(14,1,1) = {"
lL
Rk
Rk
wK
Rk
Rk
Rk
Tp
lL
lL
Tp
Rk
Rk
Ci
MK
nW
nW
nA
cM
rL
Ci
fE
Rk
Rk
fE
gz
fE
hB
wi
hB
hB
hB
gz
fE
Rk
Rk
CZ
Rk
lL
Rk
"}
(15,1,1) = {"
lL
Rk
Rk
wK
Rk
Rk
Tp
lL
lL
lL
Tp
Rk
Rk
Ci
cM
nW
nW
Ci
Ci
Ci
Ci
Av
fE
Rk
sA
Rk
fE
Rk
Rk
Rk
Rk
fE
Rk
Rk
Rk
fE
CZ
Rk
lL
Rk
"}
(16,1,1) = {"
lL
Rk
Rk
wK
Rk
rC
lL
lL
Rk
lL
Tp
cB
Rk
Ci
OM
nW
nW
al
Sf
Sf
Sf
fE
gz
fE
Rk
Rk
Ci
Ci
Ci
Ci
Ci
Ci
Ci
Ci
Ci
Ci
wK
Rk
lL
Rk
"}
(17,1,1) = {"
lL
Rk
Rk
wK
Rk
Rk
Rk
Rk
Rk
Rk
lL
Tp
Rk
Ci
Ci
Ci
Ci
Ci
uB
Rk
Sf
Rk
fE
gz
Rk
Rk
Ci
nW
OQ
ty
aZ
ty
AX
ty
ty
Ci
wK
Rk
lL
Rk
"}
(18,1,1) = {"
lL
Rk
Rk
wK
Rk
Rk
cB
Rk
Rk
Tp
lL
Tp
Rk
gz
Al
ld
fE
Ix
Rk
cB
Sf
Rk
fE
fE
Rk
Rk
Ci
xI
UI
df
rt
ty
ty
ty
ty
Ci
wK
Rk
lL
Rk
"}
(19,1,1) = {"
lL
Rk
Rk
Gs
Sf
Sf
fE
Al
Tp
lL
lL
Rk
IL
Rk
gz
ld
fE
Rk
sa
Sf
Sf
rJ
Rk
Rk
Rk
Rk
Ci
dN
Dr
nW
df
Vj
wa
Vj
Vj
Ci
wK
Rk
lL
Rk
"}
(20,1,1) = {"
Rk
Rk
Rk
Gs
Sf
Sf
Sf
Sf
Rk
gz
Rk
Rk
Rk
Rk
Rk
ld
Sf
Sf
Sf
Sf
Sf
rR
Sf
Sf
Sf
Sf
Ci
df
OQ
df
UI
df
CW
df
df
Ci
wK
Rk
lL
Rk
"}
(21,1,1) = {"
lL
Rk
Rk
wK
cB
Rk
Sf
Sf
Sf
Rk
Rk
Rk
Rk
rC
Rk
Wk
Sf
Sf
Sf
Sf
rR
HR
rR
Sf
Sf
Sf
al
nW
nW
nW
nW
nW
Tt
mE
nW
Ci
wK
Rk
lL
Rk
"}
(22,1,1) = {"
Rk
lL
Rk
wK
Rk
Rk
rC
fE
Sf
Sf
fE
fE
fE
Rk
Sf
Wk
Sf
Sf
Sf
Sf
An
rR
Sf
Sf
Sf
Sf
Ci
df
df
df
nW
df
gS
df
df
Ci
wK
Rk
lL
Rk
"}
(23,1,1) = {"
Rk
Rk
Rk
wK
Rk
Rk
fE
Al
Sf
Sf
Sf
Sf
Sf
Sf
Sf
WF
gz
Rk
xJ
Sf
Sf
Sf
sa
Rk
Ix
fE
Ci
dN
df
nW
OQ
Vj
wa
Vj
Vj
Ci
wK
Rk
Rk
lL
"}
(24,1,1) = {"
Rk
lL
Rk
wK
Rk
Rk
Rk
fE
fE
Rk
Sf
Sf
Sf
Sf
Sf
ld
fE
Av
fE
uB
Sf
mr
sl
fE
gz
Al
Ci
xI
GU
df
ty
ty
ty
ty
ty
Ci
wK
Rk
Rk
lL
"}
(25,1,1) = {"
Rk
lL
Rk
wK
Rk
Rk
Rk
Rk
Rk
Rk
Rk
rC
Rk
gz
fE
Ci
Ci
Ci
Ci
Ci
Rb
Ci
Ci
Ci
fE
Rk
Ci
nW
OQ
ty
aZ
ty
AX
ty
ty
Ci
wK
Rk
Rk
Rk
"}
(26,1,1) = {"
Rk
Rk
Rk
wK
Rk
Rk
Rk
Rk
Tp
Rk
Rk
Rk
cB
Rk
gz
Ci
df
Qk
uZ
Ci
Jt
Ci
uZ
Ci
dy
Rk
Ci
Ci
Ci
Ci
Ci
Ci
Ci
Ci
Ci
Ci
wK
lL
Rk
Rk
"}
(27,1,1) = {"
Rk
Rk
Rk
wK
Rk
Rk
sA
Tp
lL
Tp
Rk
Rk
Rk
Rk
Rk
Ci
vG
Aa
uZ
Id
uZ
uZ
Wo
Ci
Rk
Rk
Rk
Rk
Rk
Tp
gz
fE
Al
Rk
Rk
Rk
wK
lL
lL
Rk
"}
(28,1,1) = {"
Rk
Rk
Rk
wK
Rk
Rk
Rk
Tp
lL
Tp
Tp
lL
lL
Tp
Rk
Ci
df
Qk
uZ
uZ
uZ
uZ
uZ
Ci
Rk
Rk
Rk
gz
fE
Tp
Tp
Rk
Rk
Rk
Rk
Rk
wK
Rk
lL
Rk
"}
(29,1,1) = {"
Rk
Rk
lL
wK
Rk
Rk
Rk
sA
lL
Rk
lL
lL
lL
lL
Tp
Ci
df
Qk
uZ
uZ
uZ
uZ
uZ
Ci
Rk
fC
Rk
fE
sA
lL
lL
lL
Tp
Rk
lL
lL
wK
Rk
lL
lL
"}
(30,1,1) = {"
Rk
lL
Rk
wK
Rk
lL
Rk
Rk
lL
lL
lL
lL
lL
lL
Tp
Ci
ON
Aa
uZ
uZ
uZ
Id
Og
Ci
Rk
Rk
Rk
Tp
lL
lL
lL
lL
lL
lL
lL
lL
wK
Rk
Rk
lL
"}
(31,1,1) = {"
lL
lL
Rk
wK
Rk
lL
Rk
Rk
Rk
Rk
lL
lL
Tp
Tp
Rk
Ci
df
Qk
uZ
YA
uZ
uZ
uZ
Ci
Rk
sA
Rk
Rk
Tp
lL
lL
lL
lL
lL
lL
lL
wK
Rk
Rk
lL
"}
(32,1,1) = {"
lL
lL
Rk
wK
Rk
lL
lL
lL
Tp
Rk
Rk
sA
Tp
Tp
Rk
Ci
Ci
Ci
Ci
Ci
Ci
Ci
Ci
Ci
Rk
Rk
Tp
Rk
lL
lL
lL
lL
lL
lL
lL
lL
wK
Rk
Rk
lL
"}
(33,1,1) = {"
lL
Rk
Rk
wK
Rk
Rk
lL
lL
lL
sA
Rk
Rk
Tp
Rk
cB
WP
Rk
Rk
lL
lL
lL
lL
lL
Rk
Rk
Tp
lL
lL
lL
lL
lL
lL
lL
lL
lL
lL
wK
Rk
Rk
lL
"}
(34,1,1) = {"
Rk
lL
Rk
wK
Rk
Rk
Rk
Tp
lL
lL
Tp
Rk
Rk
cB
Rk
Rk
lL
lL
lL
lL
lL
lL
lL
lL
WP
lL
lL
lL
lL
lL
Tp
Tp
Tp
Rk
Tp
Tp
wK
Rk
Rk
lL
"}
(35,1,1) = {"
Rk
Rk
Rk
Pw
AT
AT
AT
AT
AT
AT
AT
AT
AT
AT
AT
AT
AT
AT
AT
AT
AT
AT
AT
AT
AT
AT
AT
AT
AT
AT
AT
AT
AT
AT
AT
AT
BI
Rk
Rk
lL
"}
(36,1,1) = {"
Rk
Rk
Rk
Rk
Rk
Rk
Rk
Rk
Rk
Rk
Rk
Rk
Rk
Rk
Rk
Rk
Rk
Rk
Rk
Rk
Rk
Rk
Rk
Rk
Rk
Rk
Rk
Rk
Rk
Rk
Rk
Rk
Rk
Rk
Rk
Rk
Rk
Rk
Rk
lL
"}
(37,1,1) = {"
Rk
Rk
Rk
Rk
Rk
lL
lL
lL
Rk
Rk
Rk
Rk
Rk
lL
lL
lL
lL
lL
lL
lL
lL
lL
lL
lL
Rk
Rk
lL
lL
lL
lL
lL
lL
lL
Rk
Rk
Rk
lL
lL
lL
Rk
"}
(38,1,1) = {"
lL
lL
lL
lL
lL
Rk
Rk
lL
lL
Rk
Rk
Rk
lL
lL
Rk
Rk
Rk
Rk
Rk
lL
Rk
Rk
Rk
lL
lL
lL
lL
Rk
Rk
Rk
Rk
Rk
lL
lL
Rk
lL
lL
lL
lL
Rk
"}
(39,1,1) = {"
Rk
Rk
Rk
Rk
lL
lL
lL
lL
Rk
lL
lL
Rk
Rk
Rk
Rk
Rk
Rk
Rk
Rk
Rk
lL
lL
Rk
Rk
Rk
Rk
lL
lL
lL
Rk
Rk
Rk
Rk
lL
lL
Rk
Rk
Rk
Rk
Rk
"}
(40,1,1) = {"
Rk
Rk
Rk
Rk
Rk
Rk
Rk
Rk
Rk
Rk
lL
lL
lL
lL
lL
lL
lL
lL
lL
lL
Rk
Rk
Rk
Rk
Rk
Rk
Rk
Rk
Rk
lL
lL
lL
lL
lL
Rk
Rk
Rk
Rk
Rk
Rk
"}
