//MAP CONVERTED BY dmm2tgm.py THIS HEADER COMMENT PREVENTS RECONVERSION, DO NOT REMOVE
"a" = (
/turf/closed/basic,
/area/rogue)
"c" = (
/obj/structure/stockpile_storage/metal,
/turf/open/floor/cobblerock,
/area/rogue)
"d" = (
/obj/machinery/light/fueled/torchholder/hotspring{
	pixel_y = -12;
	pixel_x = -16
	},
/turf/open/floor/cobblerock,
/area/rogue)
"e" = (
/obj/effect/landmark/start,
/turf/open/floor/cobblerock,
/area/rogue)
"g" = (
/obj/structure/stockpile_storage,
/turf/open/floor/cobblerock,
/area/rogue)
"k" = (
/obj/effect/landmark/start/consort,
/turf/open/floor/cobblerock,
/area/rogue)
"t" = (
/obj/structure/fake_machine/titan,
/obj/structure/throne,
/turf/open/floor/cobblerock,
/area/rogue)
"u" = (
/turf/open/floor/cobblerock,
/area/rogue)
"x" = (
/obj/structure/stockpile_storage/food,
/turf/open/floor/cobblerock,
/area/rogue)
"G" = (
/obj/effect/landmark/start/adventurerlate,
/obj/effect/landmark/latejoin,
/obj/effect/landmark/start/lord{
	dir = 8
	},
/turf/open/floor/cobblerock,
/area/rogue)
"H" = (
/obj/effect/landmark/observer_start,
/turf/open/floor/cobblerock,
/area/rogue)

(1,1,1) = {"
a
a
a
a
a
a
a
a
a
a
a
a
a
a
a
a
a
a
a
a
a
a
a
a
a
a
a
a
a
a
a
a
a
a
a
"}
(2,1,1) = {"
a
a
a
a
a
a
a
a
a
a
a
a
a
a
a
a
a
a
a
a
a
a
a
a
a
a
a
a
a
a
a
a
a
a
a
"}
(3,1,1) = {"
a
a
a
a
a
a
a
a
a
a
a
a
a
a
a
a
a
a
a
a
a
a
a
a
a
a
a
a
a
a
a
a
a
a
a
"}
(4,1,1) = {"
a
a
a
a
a
a
a
a
a
a
a
a
a
a
a
a
a
a
a
a
a
a
a
a
a
a
a
a
a
a
a
a
a
a
a
"}
(5,1,1) = {"
a
a
a
a
a
a
a
a
a
a
a
a
a
a
a
a
a
a
a
a
a
a
a
a
a
a
a
a
a
a
a
a
a
a
a
"}
(6,1,1) = {"
a
a
a
a
a
a
a
a
a
a
a
u
u
u
u
u
u
u
u
u
u
u
u
u
a
a
a
a
a
a
a
a
a
a
a
"}
(7,1,1) = {"
a
a
a
a
a
a
a
a
a
a
a
u
u
u
u
u
u
u
u
u
u
u
u
u
a
a
a
a
a
a
a
a
a
a
a
"}
(8,1,1) = {"
a
a
a
a
a
a
a
a
a
a
a
u
u
u
u
u
u
u
u
u
u
u
u
u
a
a
a
a
a
a
a
a
a
a
a
"}
(9,1,1) = {"
a
a
a
a
a
a
a
a
a
a
a
u
u
u
u
u
u
u
u
u
u
u
u
u
a
a
a
a
a
a
a
a
a
a
a
"}
(10,1,1) = {"
a
a
a
a
a
a
a
a
a
a
a
u
u
u
u
u
u
u
u
u
H
u
u
u
a
a
a
a
a
a
a
a
a
a
a
"}
(11,1,1) = {"
a
a
a
a
a
a
a
a
a
a
a
u
u
u
u
u
u
k
G
u
u
u
u
u
a
a
a
a
a
a
a
a
a
a
a
"}
(12,1,1) = {"
a
a
a
a
a
a
a
a
a
a
a
u
u
t
u
u
u
u
u
u
u
u
u
u
a
a
a
a
a
a
a
a
a
a
a
"}
(13,1,1) = {"
a
a
a
a
a
a
a
a
a
a
a
u
u
u
u
u
u
d
u
u
u
u
u
u
a
a
a
a
a
a
a
a
a
a
a
"}
(14,1,1) = {"
a
a
a
a
a
a
a
a
a
a
a
u
u
u
u
u
e
u
u
u
u
u
u
u
a
a
a
a
a
a
a
a
a
a
a
"}
(15,1,1) = {"
a
a
a
a
a
a
a
a
a
a
a
u
u
u
u
u
u
u
u
u
u
u
u
u
a
a
a
a
a
a
a
a
a
a
a
"}
(16,1,1) = {"
a
a
a
a
a
a
a
a
a
a
a
u
u
u
u
u
u
u
u
u
u
u
u
u
a
a
a
a
a
a
a
a
a
a
a
"}
(17,1,1) = {"
a
a
a
a
a
a
a
a
a
a
a
u
u
u
u
u
u
u
u
u
u
u
u
u
a
a
a
a
a
a
a
a
a
a
a
"}
(18,1,1) = {"
a
a
a
a
a
a
a
a
a
a
a
u
u
g
u
u
u
x
u
u
u
c
u
u
a
a
a
a
a
a
a
a
a
a
a
"}
(19,1,1) = {"
a
a
a
a
a
a
a
a
a
a
a
u
u
u
u
u
u
u
u
u
u
u
u
u
a
a
a
a
a
a
a
a
a
a
a
"}
(20,1,1) = {"
a
a
a
a
a
a
a
a
a
a
a
u
u
u
u
u
u
u
u
u
u
u
u
u
a
a
a
a
a
a
a
a
a
a
a
"}
(21,1,1) = {"
a
a
a
a
a
a
a
a
a
a
a
a
a
a
a
a
a
a
a
a
a
a
a
a
a
a
a
a
a
a
a
a
a
a
a
"}
(22,1,1) = {"
a
a
a
a
a
a
a
a
a
a
a
a
a
a
a
a
a
a
a
a
a
a
a
a
a
a
a
a
a
a
a
a
a
a
a
"}
(23,1,1) = {"
a
a
a
a
a
a
a
a
a
a
a
a
a
a
a
a
a
a
a
a
a
a
a
a
a
a
a
a
a
a
a
a
a
a
a
"}
(24,1,1) = {"
a
a
a
a
a
a
a
a
a
a
a
a
a
a
a
a
a
a
a
a
a
a
a
a
a
a
a
a
a
a
a
a
a
a
a
"}
(25,1,1) = {"
a
a
a
a
a
a
a
a
a
a
a
a
a
a
a
a
a
a
a
a
a
a
a
a
a
a
a
a
a
a
a
a
a
a
a
"}
