//MAP CONVERTED BY dmm2tgm.py THIS HEADER COMMENT PREVENTS RECONVERSION, DO NOT REMOVE
"a" = (
/turf/open/floor/naturalstone,
/area/template_noop)
"c" = (
/turf/open/transparent/openspace,
/area/template_noop)
"j" = (
/obj/effect/waterfall,
/turf/open/transparent/openspace,
/area/template_noop)
"o" = (
/turf/closed/mineral,
/area/template_noop)
"y" = (
/turf/template_noop,
/area/template_noop)
"A" = (
/turf/open/floor/dirt,
/area/template_noop)
"G" = (
/turf/open/water/cleanshallow,
/area/template_noop)
"M" = (
/obj/effect/waterfall,
/turf/open/water/cleanshallow,
/area/template_noop)
"Q" = (
/turf/open/floor/cobblerock,
/area/template_noop)

(1,1,1) = {"
y
y
y
a
y
o
o
a
a
a
o
"}
(2,1,1) = {"
y
y
y
a
o
o
a
a
G
G
a
"}
(3,1,1) = {"
y
y
y
a
o
a
a
G
G
G
a
"}
(4,1,1) = {"
y
y
a
o
o
a
G
G
G
G
G
"}
(5,1,1) = {"
y
y
a
o
a
a
M
G
G
G
G
"}
(6,1,1) = {"
y
y
a
o
a
a
M
G
G
G
G
"}
(7,1,1) = {"
y
y
a
o
a
a
G
G
G
G
G
"}
(8,1,1) = {"
y
y
y
a
a
a
a
a
G
G
G
"}
(9,1,1) = {"
y
y
y
y
a
o
a
a
a
G
G
"}
(10,1,1) = {"
y
y
y
y
a
o
y
o
a
a
a
"}
(11,1,1) = {"
y
y
y
y
y
y
y
o
y
o
o
"}

(1,1,2) = {"
y
y
y
y
y
y
y
y
y
y
y
"}
(2,1,2) = {"
y
y
y
y
y
a
o
o
y
y
y
"}
(3,1,2) = {"
y
y
y
y
o
a
a
a
a
o
y
"}
(4,1,2) = {"
y
y
y
o
a
a
c
a
a
a
y
"}
(5,1,2) = {"
y
y
y
o
a
j
c
c
a
a
y
"}
(6,1,2) = {"
y
y
o
o
a
j
c
c
a
o
y
"}
(7,1,2) = {"
y
y
a
a
a
c
c
c
a
o
y
"}
(8,1,2) = {"
y
y
y
a
c
c
c
a
a
y
y
"}
(9,1,2) = {"
y
y
y
o
c
a
c
a
o
a
y
"}
(10,1,2) = {"
y
y
y
o
o
a
a
a
y
y
y
"}
(11,1,2) = {"
y
y
y
y
y
y
y
y
y
y
y
"}

(1,1,3) = {"
y
y
A
A
o
o
o
o
o
y
y
"}
(2,1,3) = {"
y
y
A
o
o
Q
a
Q
o
o
A
"}
(3,1,3) = {"
y
A
o
o
a
A
c
a
A
A
Q
"}
(4,1,3) = {"
y
y
o
A
a
c
c
c
a
Q
A
"}
(5,1,3) = {"
y
A
o
A
j
c
c
c
c
A
y
"}
(6,1,3) = {"
A
o
o
a
j
c
c
c
Q
a
Q
"}
(7,1,3) = {"
A
o
Q
a
c
c
c
c
a
o
A
"}
(8,1,3) = {"
y
o
A
a
c
c
c
a
A
o
y
"}
(9,1,3) = {"
y
o
o
A
Q
c
a
A
o
o
y
"}
(10,1,3) = {"
y
A
o
o
a
Q
A
o
o
y
y
"}
(11,1,3) = {"
y
y
A
o
o
o
o
o
y
y
y
"}

(1,1,4) = {"
y
y
y
y
A
A
A
A
A
y
y
"}
(2,1,4) = {"
y
y
y
A
A
A
o
o
A
y
y
"}
(3,1,4) = {"
y
y
A
A
A
o
o
o
A
A
y
"}
(4,1,4) = {"
y
y
A
A
o
o
o
o
o
A
y
"}
(5,1,4) = {"
y
y
A
A
o
o
o
o
o
A
y
"}
(6,1,4) = {"
y
A
A
o
o
o
o
o
o
A
y
"}
(7,1,4) = {"
y
A
A
o
o
o
o
o
o
A
y
"}
(8,1,4) = {"
y
A
A
A
o
o
o
o
o
A
y
"}
(9,1,4) = {"
y
A
A
A
A
o
o
o
A
A
y
"}
(10,1,4) = {"
y
y
A
A
A
o
o
A
A
y
y
"}
(11,1,4) = {"
y
y
y
y
A
A
A
A
y
y
y
"}
