//MAP CONVERTED BY dmm2tgm.py THIS HEADER COMMENT PREVENTS RECONVERSION, DO NOT REMOVE
"aA" = (
/obj/structure/flora/ausbushes/sparsegrass,
/obj/effect/decal/cleanable/blood,
/obj/effect/decal/cleanable/blood,
/obj/item/ammo_casing/caseless/arrow,
/turf/open/floor/grass,
/area/rogue/under/tomb/wilds)
"aH" = (
/obj/structure/flora/ausbushes/sparsegrass,
/obj/structure/flora/ausbushes/sparsegrass,
/obj/structure/flora/ausbushes/sparsegrass,
/obj/structure/flora/ausbushes/sparsegrass,
/obj/item/weapon/sword/iron,
/turf/open/floor/grass,
/area/rogue/under/tomb/wilds)
"aM" = (
/obj/structure/flora/ausbushes/sparsegrass,
/obj/effect/decal/cleanable/blood,
/turf/open/floor/grass,
/area/rogue/under/tomb/wilds)
"bc" = (
/obj/structure/flora/ausbushes/grassybush,
/turf/open/floor/grass,
/area/rogue/under/tomb/wilds)
"bm" = (
/obj/effect/decal/cleanable/blood/tracks,
/turf/open/floor/dirt,
/area/rogue/under/tomb/wilds)
"bB" = (
/obj/structure/flora/ausbushes/grassybush,
/obj/effect/decal/cleanable/blood/tracks,
/turf/open/floor/grass,
/area/rogue/under/tomb/wilds)
"cv" = (
/obj/structure/flora/ausbushes/sparsegrass,
/obj/structure/flora/ausbushes/sparsegrass,
/obj/structure/flora/ausbushes/ywflowers,
/obj/structure/barricade/wooden,
/obj/structure/barricade/wooden/crude,
/turf/open/floor/grass,
/area/rogue/under/tomb/wilds)
"cN" = (
/obj/structure/flora/ausbushes/fullgrass,
/obj/structure/flora/ausbushes/brflowers,
/obj/structure/flora/ausbushes/sparsegrass,
/turf/open/floor/dirt,
/area/rogue/under/tomb/wilds)
"dK" = (
/obj/structure/flora/ausbushes/fullgrass,
/turf/open/floor/grass,
/area/rogue/under/tomb/wilds)
"dV" = (
/obj/structure/flora/ausbushes/fullgrass,
/obj/structure/flora/ausbushes/sparsegrass,
/obj/item/ammo_casing/caseless/arrow,
/turf/open/floor/dirt,
/area/rogue/under/tomb/wilds)
"es" = (
/obj/item/ammo_casing/caseless/arrow,
/turf/open/floor/dirt,
/area/rogue/under/tomb/wilds)
"gn" = (
/obj/structure/flora/grass,
/obj/item/ammo_casing/caseless/arrow,
/turf/open/floor/dirt/road,
/area/rogue/under/tomb/wilds)
"hh" = (
/obj/structure/flora/ausbushes/brflowers,
/obj/structure/flora/ausbushes/sparsegrass,
/obj/structure/flora/ausbushes/sparsegrass,
/obj/effect/decal/cleanable/blood,
/turf/open/floor/grass,
/area/rogue/under/tomb/wilds)
"hl" = (
/obj/structure/flora/ausbushes/fullgrass,
/obj/structure/flora/ausbushes/sparsegrass,
/turf/open/floor/grass,
/area/rogue/under/tomb/wilds)
"hy" = (
/obj/structure/flora/grass/bush,
/obj/structure/flora/ausbushes/fullgrass,
/obj/effect/decal/cleanable/blood,
/turf/open/floor/grass,
/area/rogue/under/tomb/wilds)
"id" = (
/obj/effect/decal/cleanable/blood,
/turf/open/floor/naturalstone,
/area/rogue/under/tomb/cave)
"is" = (
/obj/structure/flora/ausbushes/sparsegrass,
/obj/effect/decal/cleanable/blood/gibs,
/turf/open/floor/grass,
/area/rogue/under/tomb/wilds)
"jg" = (
/obj/structure/flora/grass/bush_meagre,
/obj/structure/flora/ausbushes/fullgrass,
/turf/open/floor/grass,
/area/rogue/under/tomb/wilds)
"jV" = (
/obj/structure/flora/ausbushes/fullgrass,
/obj/structure/flora/ausbushes/sparsegrass,
/obj/effect/decal/cleanable/blood/tracks,
/obj/structure/barricade/wooden,
/obj/structure/barricade/wooden/crude,
/turf/open/floor/grass,
/area/rogue/under/tomb/wilds)
"kv" = (
/turf/closed/mineral/bedrock,
/area/rogue/under/tomb/wilds)
"kO" = (
/obj/structure/flora/ausbushes/sparsegrass,
/obj/effect/decal/cleanable/blood,
/obj/item/alch/bone,
/turf/open/floor/dirt,
/area/rogue/under/tomb/wilds)
"kY" = (
/obj/structure/flora/ausbushes/sparsegrass,
/obj/structure/flora/ausbushes/ywflowers,
/turf/open/floor/dirt,
/area/rogue/under/tomb/wilds)
"lg" = (
/obj/item/weapon/sword/iron,
/turf/open/floor/naturalstone,
/area/rogue/under/tomb/cave)
"lq" = (
/obj/structure/flora/ausbushes/sparsegrass,
/turf/open/floor/grass,
/area/rogue/under/tomb/wilds)
"lE" = (
/obj/structure/flora/ausbushes/sparsegrass,
/obj/structure/flora/ausbushes/sparsegrass,
/obj/effect/decal/cleanable/blood,
/turf/open/floor/grass,
/area/rogue/under/tomb/wilds)
"lP" = (
/obj/structure/flora/grass/bush,
/obj/structure/flora/ausbushes/sparsegrass,
/turf/open/floor/dirt,
/area/rogue/under/tomb/wilds)
"mK" = (
/obj/structure/flora/ausbushes/fullgrass,
/obj/structure/flora/ausbushes/ywflowers,
/turf/open/floor/grass,
/area/rogue/under/tomb/wilds)
"of" = (
/obj/structure/flora/ausbushes/sparsegrass,
/obj/structure/flora/ausbushes/sparsegrass,
/obj/effect/decal/remains/human,
/turf/open/floor/dirt,
/area/rogue/under/tomb/wilds)
"ol" = (
/obj/structure/flora/ausbushes/sparsegrass,
/obj/effect/decal/cleanable/blood,
/turf/open/floor/dirt,
/area/rogue/under/tomb/wilds)
"or" = (
/turf/open/water/cleanshallow,
/area/rogue/under/tomb/cave)
"oF" = (
/obj/effect/dungeon_directional_helper/west,
/turf/open/floor/dirt/road,
/area/rogue/under/tomb/wilds)
"pa" = (
/obj/structure/flora/grass/bush_meagre,
/obj/structure/flora/ausbushes/sparsegrass,
/turf/open/floor/grass,
/area/rogue/under/tomb/wilds)
"pb" = (
/obj/effect/decal/cleanable/blood/tracks,
/obj/item/alch/bonemeal,
/turf/open/floor/dirt,
/area/rogue/under/tomb/wilds)
"pY" = (
/obj/structure/flora/ausbushes/sparsegrass,
/obj/structure/flora/ausbushes/sparsegrass,
/turf/open/floor/dirt,
/area/rogue/under/tomb/wilds)
"qC" = (
/obj/effect/decal/cleanable/blood/gibs,
/obj/effect/decal/cleanable/blood/tracks,
/obj/item/ammo_casing/caseless/arrow,
/turf/open/floor/dirt,
/area/rogue/under/tomb/wilds)
"qT" = (
/obj/effect/decal/cleanable/blood,
/obj/effect/spawner/map_spawner/loot,
/turf/open/floor/dirt,
/area/rogue/under/tomb/cave)
"rq" = (
/obj/structure/flora/ausbushes/fullgrass,
/obj/effect/decal/cleanable/blood/splatter,
/obj/item/alch/bone,
/turf/open/floor/dirt,
/area/rogue/under/tomb/wilds)
"rK" = (
/turf/closed/mineral/bedrock,
/area/rogue/under/tomb)
"rS" = (
/obj/structure/flora/grass/bush_meagre,
/obj/structure/flora/ausbushes/sparsegrass,
/obj/effect/decal/cleanable/blood/gibs/torso,
/turf/open/floor/grass,
/area/rogue/under/tomb/wilds)
"td" = (
/obj/structure/flora/ausbushes/fullgrass,
/obj/structure/flora/ausbushes/brflowers,
/turf/open/floor/grass,
/area/rogue/under/tomb/wilds)
"tB" = (
/obj/effect/decal/cleanable/blood/gibs,
/turf/open/floor/dirt,
/area/rogue/under/tomb/wilds)
"tS" = (
/obj/structure/flora/ausbushes/fullgrass,
/obj/effect/decal/cleanable/blood/gibs,
/turf/open/floor/grass,
/area/rogue/under/tomb/wilds)
"uc" = (
/turf/open/transparent/openspace,
/area/rogue/under/tomb)
"uC" = (
/obj/structure/flora/grass,
/obj/effect/decal/cleanable/blood,
/turf/open/floor/dirt,
/area/rogue/under/tomb/wilds)
"uR" = (
/obj/structure/flora/grass/bush/wall/tall,
/turf/open/floor/dirt,
/area/rogue/under/tomb/wilds)
"uY" = (
/obj/structure/flora/grass/bush,
/obj/structure/flora/ausbushes/sparsegrass,
/turf/open/floor/grass,
/area/rogue/under/tomb/wilds)
"vf" = (
/turf/closed/mineral/bedrock,
/area/rogue/under/tomb/cave)
"wk" = (
/obj/structure/flora/ausbushes/sparsegrass,
/obj/item/alch/bonemeal,
/turf/open/floor/grass,
/area/rogue/under/tomb/wilds)
"xe" = (
/obj/structure/flora/ausbushes/fullgrass,
/obj/item/alch/bone,
/turf/open/floor/grass,
/area/rogue/under/tomb/wilds)
"xp" = (
/obj/structure/flora/ausbushes/fullgrass,
/obj/effect/decal/cleanable/blood,
/turf/open/floor/grass,
/area/rogue/under/tomb/wilds)
"xC" = (
/obj/effect/decal/remains/human,
/turf/open/floor/dirt,
/area/rogue/under/tomb/wilds)
"yd" = (
/obj/structure/flora/grass,
/obj/effect/decal/cleanable/blood/tracks,
/turf/open/floor/dirt,
/area/rogue/under/tomb/wilds)
"yR" = (
/obj/structure/flora/ausbushes/sparsegrass,
/obj/structure/flora/ausbushes/sparsegrass,
/obj/effect/decal/cleanable/blood/tracks,
/turf/open/floor/grass,
/area/rogue/under/tomb/wilds)
"zs" = (
/obj/structure/flora/grass/bush,
/obj/effect/decal/cleanable/blood/gibs/torso,
/turf/open/floor/grass,
/area/rogue/under/tomb/wilds)
"Bz" = (
/obj/structure/flora/grass/bush,
/turf/open/floor/dirt,
/area/rogue/under/tomb/wilds)
"BT" = (
/obj/effect/dungeon_directional_helper/east,
/turf/open/floor/dirt/road,
/area/rogue/under/tomb/wilds)
"CP" = (
/obj/effect/decal/cleanable/blood,
/turf/open/floor/dirt,
/area/rogue/under/tomb/wilds)
"Dc" = (
/obj/structure/flora/ausbushes/sparsegrass,
/obj/item/ammo_casing/caseless/arrow,
/turf/open/floor/dirt,
/area/rogue/under/tomb/wilds)
"DR" = (
/obj/structure/flora/ausbushes/sparsegrass,
/obj/structure/flora/ausbushes/ywflowers,
/turf/open/floor/grass,
/area/rogue/under/tomb/wilds)
"Ec" = (
/obj/structure/flora/ausbushes/fullgrass,
/obj/effect/decal/cleanable/blood/gibs,
/obj/effect/decal/cleanable/blood/splatter,
/obj/item/alch/bonemeal,
/turf/open/floor/grass,
/area/rogue/under/tomb/wilds)
"Ek" = (
/obj/structure/flora/ausbushes/fullgrass,
/turf/open/floor/dirt,
/area/rogue/under/tomb/wilds)
"Ev" = (
/obj/structure/flora/ausbushes/sparsegrass,
/obj/effect/decal/cleanable/blood/tracks,
/turf/open/floor/grass,
/area/rogue/under/tomb/wilds)
"Ex" = (
/obj/structure/flora/grass/bush_meagre,
/turf/open/floor/grass,
/area/rogue/under/tomb/wilds)
"Fs" = (
/obj/structure/flora/ausbushes/sparsegrass,
/obj/effect/decal/cleanable/blood/gibs/torso,
/turf/open/floor/dirt,
/area/rogue/under/tomb/wilds)
"Ga" = (
/obj/structure/flora/ausbushes/sunnybush,
/turf/open/floor/grass,
/area/rogue/under/tomb/wilds)
"Gj" = (
/obj/structure/flora/ausbushes/fullgrass,
/obj/item/ammo_casing/caseless/arrow,
/turf/open/floor/dirt,
/area/rogue/under/tomb/wilds)
"Hi" = (
/obj/structure/flora/ausbushes/sparsegrass,
/obj/structure/flora/ausbushes/sparsegrass,
/turf/open/floor/grass,
/area/rogue/under/tomb/wilds)
"HA" = (
/obj/effect/decal/remains/human,
/turf/open/floor/dirt/road,
/area/rogue/under/tomb/wilds)
"HW" = (
/obj/structure/flora/ausbushes/sparsegrass,
/obj/item/weapon/sword/rapier/ironestoc,
/turf/open/floor/grass,
/area/rogue/under/tomb/wilds)
"HY" = (
/obj/item/weapon/axe/iron,
/turf/open/floor/dirt,
/area/rogue/under/tomb/wilds)
"Id" = (
/turf/open/floor/grass,
/area/rogue/under/tomb/wilds)
"Io" = (
/obj/structure/flora/grass,
/turf/open/floor/dirt,
/area/rogue/under/tomb/wilds)
"Jh" = (
/turf/open/floor/dirt/road,
/area/rogue/under/tomb/wilds)
"Kp" = (
/obj/structure/flora/ausbushes/fullgrass,
/obj/structure/flora/ausbushes/sparsegrass,
/obj/effect/decal/cleanable/blood,
/turf/open/floor/grass,
/area/rogue/under/tomb/wilds)
"KW" = (
/obj/effect/spawner/map_spawner/loot,
/turf/open/floor/dirt,
/area/rogue/under/tomb/cave)
"KX" = (
/obj/structure/flora/grass,
/mob/living/simple_animal/hostile/retaliate/troll/caerbannog,
/turf/open/floor/dirt,
/area/rogue/under/tomb/wilds)
"Lb" = (
/obj/effect/decal/cleanable/blood,
/turf/open/floor/dirt,
/area/rogue/under/tomb/cave)
"Lj" = (
/obj/structure/flora/ausbushes/brflowers,
/turf/open/floor/grass,
/area/rogue/under/tomb/wilds)
"Md" = (
/obj/structure/flora/ausbushes/fullgrass,
/obj/structure/flora/ausbushes/sparsegrass,
/obj/effect/decal/cleanable/blood/gibs,
/turf/open/floor/grass,
/area/rogue/under/tomb/wilds)
"MO" = (
/obj/effect/spawner/map_spawner/loot,
/turf/open/floor/naturalstone,
/area/rogue/under/tomb/cave)
"Nd" = (
/obj/structure/flora/ausbushes/sparsegrass,
/obj/item/weapon/axe/iron,
/turf/open/floor/dirt,
/area/rogue/under/tomb/wilds)
"Pr" = (
/obj/item/ammo_casing/caseless/arrow,
/turf/open/floor/dirt/road,
/area/rogue/under/tomb/wilds)
"Pw" = (
/obj/structure/flora/grass,
/turf/open/floor/grass,
/area/rogue/under/tomb/wilds)
"PA" = (
/obj/structure/flora/grass,
/obj/effect/decal/remains/human,
/turf/open/floor/dirt,
/area/rogue/under/tomb/wilds)
"Qo" = (
/obj/effect/decal/cleanable/blood,
/turf/open/floor/dirt/road,
/area/rogue/under/tomb/wilds)
"Ss" = (
/obj/structure/flora/ausbushes/sparsegrass,
/obj/effect/decal/remains/human,
/turf/open/floor/dirt,
/area/rogue/under/tomb/wilds)
"SJ" = (
/obj/structure/flora/ausbushes/sparsegrass,
/obj/effect/decal/remains/human,
/mob/living/simple_animal/hostile/retaliate/troll/caerbannog,
/turf/open/floor/grass,
/area/rogue/under/tomb/wilds)
"Tg" = (
/obj/structure/flora/grass,
/obj/item/alch/bone,
/turf/open/floor/dirt,
/area/rogue/under/tomb/wilds)
"Ti" = (
/turf/open/floor/dirt,
/area/rogue/under/tomb/wilds)
"Tj" = (
/obj/structure/flora/grass/bush,
/turf/open/floor/grass,
/area/rogue/under/tomb/wilds)
"Tv" = (
/obj/structure/flora/ausbushes/sparsegrass,
/obj/structure/flora/ausbushes/sparsegrass,
/obj/structure/flora/ausbushes/sparsegrass,
/obj/structure/flora/grass,
/turf/open/floor/dirt,
/area/rogue/under/tomb/wilds)
"Ug" = (
/obj/structure/flora/ausbushes/sparsegrass,
/turf/open/floor/dirt,
/area/rogue/under/tomb/wilds)
"Uj" = (
/obj/structure/flora/grass/bush_meagre,
/turf/open/floor/dirt,
/area/rogue/under/tomb/wilds)
"Ux" = (
/obj/item/alch/bone,
/turf/open/floor/dirt/road,
/area/rogue/under/tomb/wilds)
"UI" = (
/obj/structure/fluff/customsign{
	desc = "BEWARE THE BEAST!";
	name = "Blood Covered Sign"
	},
/turf/open/floor/dirt,
/area/rogue/under/tomb/wilds)
"Vf" = (
/obj/structure/flora/grass/bush_meagre,
/obj/structure/flora/ausbushes/sparsegrass,
/turf/open/floor/dirt,
/area/rogue/under/tomb/wilds)
"VX" = (
/obj/structure/flora/ausbushes/brflowers,
/obj/structure/flora/ausbushes/sparsegrass,
/turf/open/floor/dirt,
/area/rogue/under/tomb/wilds)
"Wf" = (
/turf/open/floor/dirt,
/area/rogue/under/tomb/cave)
"Wy" = (
/turf/open/floor/naturalstone,
/area/rogue/under/tomb/cave)
"WK" = (
/obj/structure/flora/ausbushes/fullgrass,
/obj/effect/decal/cleanable/blood/tracks,
/turf/open/floor/grass,
/area/rogue/under/tomb/wilds)
"Xk" = (
/obj/structure/flora/grass,
/turf/open/floor/dirt/road,
/area/rogue/under/tomb/wilds)
"Xu" = (
/obj/structure/fluff/nest,
/obj/effect/spawner/map_spawner/loot/medium,
/turf/open/floor/dirt,
/area/rogue/under/tomb/cave)
"YJ" = (
/obj/structure/flora/ausbushes/fullgrass,
/obj/structure/barricade/wooden,
/obj/structure/barricade/wooden/crude,
/turf/open/floor/dirt,
/area/rogue/under/tomb/wilds)
"Zv" = (
/obj/structure/flora/grass,
/obj/effect/decal/cleanable/blood/splatter,
/turf/open/floor/dirt,
/area/rogue/under/tomb/wilds)

(1,1,1) = {"
vf
vf
vf
vf
vf
vf
kv
kv
kv
kv
kv
kv
kv
kv
kv
kv
kv
kv
kv
Ti
oF
Ti
Xk
Pw
kv
"}
(2,1,1) = {"
vf
vf
vf
vf
vf
vf
kv
Uj
lq
uY
kv
kv
kv
kv
kv
kv
kv
kv
Ga
Io
Ti
Ti
Xk
kv
kv
"}
(3,1,1) = {"
vf
vf
vf
vf
vf
vf
uR
lq
Kp
HW
Uj
kv
kv
kv
kv
kv
kv
kv
Ti
HA
Ti
Ti
kv
kv
kv
"}
(4,1,1) = {"
vf
vf
Wy
Wy
vf
vf
Tj
hl
PA
td
Tj
Ex
kv
kv
kv
kv
kv
kv
kv
Ti
Ti
Ti
kv
kv
kv
"}
(5,1,1) = {"
vf
Wy
qT
id
vf
vf
kv
rS
xp
Ti
dV
lE
kY
kv
uR
Uj
kv
kv
kv
gn
Io
Ti
Jh
kv
kv
"}
(6,1,1) = {"
vf
Xu
Wf
Wf
MO
vf
Id
Io
mK
bc
Ec
Ug
xe
lq
CP
zs
Bz
kv
kv
lq
Jh
Zv
Ti
kv
kv
"}
(7,1,1) = {"
vf
id
Wf
Wf
Wf
lg
Ti
KX
aM
of
CP
Ug
bc
Ti
Lj
HY
lP
kv
CP
Ti
Ti
HA
Ti
dK
kv
"}
(8,1,1) = {"
vf
or
Wy
Wf
Lb
Wy
kv
Dc
lq
Id
cN
pY
tB
Ss
dK
Ek
lq
cv
pY
Ux
Ti
Ti
Jh
dK
kv
"}
(9,1,1) = {"
vf
id
Wf
Wf
vf
Wf
Ti
lq
ol
rq
yd
yR
Ev
yd
bB
qC
pb
jV
WK
bm
tS
Jh
Qo
Tj
kv
"}
(10,1,1) = {"
vf
or
id
KW
vf
vf
Uj
bc
hl
Gj
Tv
aH
VX
Ss
Tg
lq
hh
YJ
dK
Ti
Jh
Pr
Ti
kv
kv
"}
(11,1,1) = {"
vf
vf
or
vf
vf
vf
kv
Nd
Pw
SJ
kO
Fs
Io
aA
Io
Hi
Tj
kv
xC
Ti
Ti
lq
kv
kv
kv
"}
(12,1,1) = {"
vf
vf
vf
vf
vf
vf
Tj
Ek
lE
is
lq
DR
Md
Io
Tj
pa
kv
kv
UI
Zv
Jh
Ti
kv
kv
kv
"}
(13,1,1) = {"
vf
vf
vf
vf
vf
vf
jg
jg
Lj
Ek
Ek
lq
wk
Vf
kv
kv
kv
kv
kv
es
Jh
Ti
Jh
kv
kv
"}
(14,1,1) = {"
vf
vf
vf
vf
vf
vf
kv
uR
Ex
kv
hy
dK
kv
kv
kv
kv
kv
kv
kv
Jh
uC
HA
Xk
kv
kv
"}
(15,1,1) = {"
vf
vf
vf
vf
vf
vf
kv
kv
kv
kv
kv
kv
kv
kv
kv
kv
kv
kv
kv
Ti
BT
Ti
Jh
lq
kv
"}

(1,1,2) = {"
rK
rK
rK
rK
rK
rK
rK
rK
rK
rK
rK
rK
rK
rK
rK
rK
rK
rK
rK
uc
uc
uc
rK
rK
rK
"}
(2,1,2) = {"
rK
rK
rK
rK
rK
rK
rK
rK
rK
rK
rK
rK
rK
rK
rK
rK
rK
rK
uc
uc
uc
uc
uc
rK
rK
"}
(3,1,2) = {"
rK
rK
rK
rK
rK
rK
rK
rK
rK
rK
rK
rK
rK
rK
rK
rK
rK
rK
uc
uc
uc
uc
rK
rK
rK
"}
(4,1,2) = {"
rK
rK
rK
rK
rK
rK
rK
rK
rK
rK
rK
rK
rK
rK
rK
rK
rK
rK
rK
uc
uc
uc
rK
rK
rK
"}
(5,1,2) = {"
rK
rK
rK
rK
rK
rK
rK
rK
rK
rK
rK
rK
rK
rK
rK
rK
rK
rK
rK
rK
uc
uc
uc
rK
rK
"}
(6,1,2) = {"
rK
rK
rK
rK
rK
rK
rK
rK
rK
rK
rK
rK
rK
rK
rK
rK
rK
rK
rK
uc
uc
uc
uc
rK
rK
"}
(7,1,2) = {"
rK
rK
rK
rK
rK
rK
rK
rK
rK
rK
rK
rK
rK
rK
rK
rK
rK
rK
uc
uc
uc
uc
rK
rK
rK
"}
(8,1,2) = {"
rK
rK
rK
rK
rK
rK
rK
rK
rK
rK
rK
rK
rK
rK
rK
rK
rK
rK
uc
uc
uc
uc
rK
rK
rK
"}
(9,1,2) = {"
rK
rK
rK
rK
rK
rK
rK
rK
rK
rK
rK
rK
rK
rK
rK
rK
rK
uc
uc
uc
rK
rK
rK
rK
rK
"}
(10,1,2) = {"
rK
rK
rK
rK
rK
rK
rK
rK
rK
rK
rK
rK
rK
rK
rK
rK
rK
uc
uc
uc
uc
rK
rK
rK
rK
"}
(11,1,2) = {"
rK
rK
rK
rK
rK
rK
rK
rK
rK
rK
rK
rK
rK
rK
rK
rK
rK
rK
uc
uc
uc
uc
rK
rK
rK
"}
(12,1,2) = {"
rK
rK
rK
rK
rK
rK
rK
rK
rK
rK
rK
rK
rK
rK
rK
rK
rK
rK
uc
uc
uc
uc
rK
rK
rK
"}
(13,1,2) = {"
rK
rK
rK
rK
rK
rK
rK
rK
rK
rK
rK
rK
rK
rK
rK
rK
rK
rK
rK
uc
uc
uc
uc
rK
rK
"}
(14,1,2) = {"
rK
rK
rK
rK
rK
rK
rK
rK
rK
rK
rK
rK
rK
rK
rK
rK
rK
rK
rK
uc
uc
uc
uc
rK
rK
"}
(15,1,2) = {"
rK
rK
rK
rK
rK
rK
rK
rK
rK
rK
rK
rK
rK
rK
rK
rK
rK
rK
rK
rK
uc
uc
rK
rK
rK
"}
