//MAP CONVERTED BY dmm2tgm.py THIS HEADER COMMENT PREVENTS RECONVERSION, DO NOT REMOVE
"a" = (
/obj/structure/spider/stickyweb,
/turf/open/floor/naturalstone,
/area/template_noop)
"g" = (
/turf/closed/mineral,
/area/template_noop)
"j" = (
/turf/template_noop,
/area/template_noop)
"u" = (
/obj/effect/waterfall{
	pixel_y = 0
	},
/turf/open/water/cleanshallow,
/area/template_noop)
"y" = (
/obj/structure/flora/grass/herb/rosa,
/turf/open/floor/grass/cold,
/area/template_noop)
"A" = (
/turf/open/water/cleanshallow,
/area/template_noop)
"B" = (
/obj/item/alch/herb/rosa,
/turf/open/water/cleanshallow,
/area/template_noop)
"E" = (
/turf/open/transparent/openspace,
/area/template_noop)
"J" = (
/obj/effect/waterfall,
/turf/open/water/cleanshallow,
/area/template_noop)
"M" = (
/obj/effect/decal/remains/human,
/turf/open/floor/naturalstone,
/area/template_noop)
"N" = (
/turf/open/floor/grass/cold,
/area/template_noop)
"P" = (
/mob/living/simple_animal/hostile/retaliate/spider/mutated,
/turf/open/floor/naturalstone,
/area/template_noop)
"T" = (
/turf/open/floor/naturalstone,
/area/template_noop)

(1,1,1) = {"
j
j
j
j
A
A
A
A
A
A
A
A
A
j
j
j
"}
(2,1,1) = {"
j
j
j
A
A
A
A
A
A
A
A
A
A
A
j
j
"}
(3,1,1) = {"
j
j
A
A
A
g
g
g
g
g
g
g
A
A
A
j
"}
(4,1,1) = {"
j
A
A
A
g
g
T
T
T
M
g
g
g
A
A
A
"}
(5,1,1) = {"
A
A
A
g
a
a
T
P
a
g
g
g
g
g
A
A
"}
(6,1,1) = {"
A
u
g
T
T
T
g
g
g
g
g
a
P
g
u
A
"}
(7,1,1) = {"
A
u
g
a
T
T
T
g
g
T
a
a
a
a
u
A
"}
(8,1,1) = {"
A
u
g
g
a
T
a
g
T
P
a
T
g
g
u
A
"}
(9,1,1) = {"
A
u
g
g
M
T
a
T
a
T
T
g
g
g
A
A
"}
(10,1,1) = {"
A
A
g
g
g
T
T
a
a
T
g
g
g
g
A
A
"}
(11,1,1) = {"
A
A
A
g
g
g
a
T
T
a
g
a
M
g
A
A
"}
(12,1,1) = {"
j
A
A
A
g
g
g
g
P
T
T
T
a
g
A
A
"}
(13,1,1) = {"
j
j
A
A
A
g
g
g
g
g
g
g
g
A
A
A
"}
(14,1,1) = {"
j
j
j
A
A
A
g
g
g
g
g
A
A
A
A
j
"}
(15,1,1) = {"
j
j
j
j
A
A
A
A
J
J
A
A
A
A
j
j
"}
(16,1,1) = {"
j
j
j
j
j
A
A
A
A
A
A
A
j
j
j
j
"}

(1,1,2) = {"
j
j
j
j
E
E
E
E
E
E
E
E
E
j
j
j
"}
(2,1,2) = {"
j
j
j
E
E
E
E
E
E
E
E
E
E
E
j
j
"}
(3,1,2) = {"
j
j
E
E
E
N
N
N
N
N
N
N
E
E
E
j
"}
(4,1,2) = {"
j
E
E
E
N
N
y
A
A
B
T
y
N
E
E
E
"}
(5,1,2) = {"
E
E
E
N
N
y
A
A
A
A
A
T
T
T
E
E
"}
(6,1,2) = {"
E
E
A
A
y
A
A
A
B
A
A
A
A
A
E
E
"}
(7,1,2) = {"
E
E
A
B
A
A
A
A
A
A
A
A
A
B
E
E
"}
(8,1,2) = {"
E
E
A
A
A
A
B
A
A
A
A
B
A
A
E
E
"}
(9,1,2) = {"
E
E
A
A
A
A
A
A
A
A
A
A
A
T
E
E
"}
(10,1,2) = {"
E
E
N
y
A
A
A
A
A
A
A
A
T
y
E
E
"}
(11,1,2) = {"
E
E
E
N
N
y
A
B
A
A
T
y
N
N
E
E
"}
(12,1,2) = {"
j
E
E
E
N
N
y
A
A
T
y
N
N
N
E
E
"}
(13,1,2) = {"
j
j
E
E
E
N
N
A
A
N
N
N
N
E
E
E
"}
(14,1,2) = {"
j
j
j
E
E
E
N
B
A
N
N
E
E
E
E
j
"}
(15,1,2) = {"
j
j
j
j
E
E
E
E
E
E
E
E
E
E
j
j
"}
(16,1,2) = {"
j
j
j
j
j
E
E
E
E
E
E
E
j
j
j
j
"}
