//MAP CONVERTED BY dmm2tgm.py THIS HEADER COMMENT PREVENTS RECONVERSION, DO NOT REMOVE
"a" = (
/turf/open/floor/dirt/road,
/area/rogue/outdoors/caves)
"b" = (
/obj/structure/table/wood/nice/decorated,
/obj/item/candle/yellow/lit/infinite/strong/skull,
/obj/item/reagent_containers/glass/bottle/stronghealthpot,
/obj/item/reagent_containers/glass/bottle/redwine,
/obj/item/statue/gold,
/turf/open/floor/ruinedwood/chevron,
/area/rogue/outdoors/caves)
"c" = (
/mob/living/carbon/human/species/orc/ambush,
/turf/open/floor/dirt/road,
/area/rogue/outdoors/caves)
"d" = (
/obj/structure/table/vtable/v2,
/obj/item/book/godofdreamsandnightmares,
/obj/item/natural/feather,
/turf/open/floor/ruinedwood/chevron,
/area/rogue/outdoors/caves)
"e" = (
/obj/item/weapon/shield/tower/buckleriron,
/obj/item/weapon/sword/khopesh,
/obj/item/clothing/face/facemask/copper,
/obj/item/clothing/neck/gorget/copper,
/obj/item/clothing/wrists/bracers/copper,
/obj/item/clothing/head/helmet/coppercap,
/obj/item/clothing/armor/cuirass/copperchest,
/obj/structure/closet/crate/chest,
/turf/open/floor/cobblerock/alt,
/area/rogue/outdoors/caves)
"f" = (
/obj/machinery/light/fueled/firebowl/standing,
/turf/open/floor/dirt/road,
/area/rogue/outdoors/caves)
"j" = (
/turf/closed/wall/mineral/wooddark/horizontal,
/area/rogue/outdoors/caves)
"l" = (
/obj/effect/dungeon_directional_helper/south,
/turf/open/floor/dirt/road,
/area/rogue/outdoors/caves)
"m" = (
/obj/effect/dungeon_directional_helper/north,
/turf/open/floor/dirt/road,
/area/rogue/outdoors/caves)
"o" = (
/obj/structure/bookcase/random/legends,
/turf/open/floor/ruinedwood/chevron,
/area/rogue/outdoors/caves)
"p" = (
/obj/structure/table/vtable,
/obj/item/paper/scroll,
/obj/item/clothing/ring/gold,
/turf/open/floor/ruinedwood/chevron,
/area/rogue/outdoors/caves)
"q" = (
/turf/open/floor/cobblerock/alt,
/area/rogue/outdoors/caves)
"r" = (
/obj/structure/mineral_door/wood/fancywood,
/turf/open/floor/ruinedwood/chevron,
/area/rogue/outdoors/caves)
"s" = (
/obj/structure/fermentation_keg/water,
/turf/open/floor/ruinedwood/chevron,
/area/rogue/outdoors/caves)
"u" = (
/obj/structure/fermentation_keg/beer,
/turf/open/floor/ruinedwood/chevron,
/area/rogue/outdoors/caves)
"z" = (
/turf/closed/mineral/bedrock,
/area/rogue/outdoors/caves)
"B" = (
/obj/structure/chair/wood,
/turf/open/floor/ruinedwood/chevron,
/area/rogue/outdoors/caves)
"C" = (
/turf/closed/wall/mineral/wooddark/vertical,
/area/rogue/outdoors/caves)
"D" = (
/obj/machinery/light/fueled/wallfire/candle/weak/l,
/turf/open/floor/ruinedwood/chevron,
/area/rogue/outdoors/caves)
"H" = (
/obj/structure/table/wood/nice/decorated,
/obj/item/clothing/face/cigarette/pipe/westman,
/obj/item/reagent_containers/food/snacks/produce/dry_westleach,
/obj/item/reagent_containers/food/snacks/produce/dry_westleach,
/obj/item/reagent_containers/food/snacks/produce/dry_westleach,
/obj/item/reagent_containers/glass/cup/skull,
/obj/item/reagent_containers/glass/cup/silver,
/turf/open/floor/ruinedwood/chevron,
/area/rogue/outdoors/caves)
"J" = (
/obj/machinery/light/fueled/wallfire/candle/r,
/mob/living/carbon/human/species/skeleton/npc/warrior/skilled,
/turf/open/floor/ruinedwood/chevron,
/area/rogue/outdoors/caves)
"K" = (
/obj/structure/table/wood/plain/alt,
/obj/machinery/light/fueled/wallfire/candle/weak/l,
/obj/item/reagent_containers/food/snacks/cheddar/aged,
/obj/item/reagent_containers/glass/cup/skull,
/turf/open/floor/cobblerock/alt,
/area/rogue/outdoors/caves)
"N" = (
/turf/closed/wall/mineral/wooddark/end,
/area/rogue/outdoors/caves)
"O" = (
/obj/structure/chair/wood/alt/chair_noble/purple,
/turf/open/floor/ruinedwood/chevron,
/area/rogue/outdoors/caves)
"P" = (
/obj/machinery/light/fueled/wallfire/candle/r,
/turf/open/floor/ruinedwood/chevron,
/area/rogue/outdoors/caves)
"R" = (
/obj/structure/bed/shit,
/turf/open/floor/cobblerock/alt,
/area/rogue/outdoors/caves)
"S" = (
/obj/effect/dungeon_directional_helper/west,
/turf/open/floor/dirt/road,
/area/rogue/outdoors/caves)
"V" = (
/turf/open/floor/ruinedwood/chevron,
/area/rogue/outdoors/caves)
"W" = (
/obj/structure/mineral_door/wood/donjon/stone,
/turf/open/floor/cobblerock/alt,
/area/rogue/outdoors/caves)
"X" = (
/obj/structure/bed/inn/double,
/turf/open/floor/ruinedwood/chevron,
/area/rogue/outdoors/caves)
"Y" = (
/obj/effect/dungeon_directional_helper/east,
/turf/open/floor/dirt/road,
/area/rogue/outdoors/caves)

(1,1,1) = {"
z
z
S
z
z
z
z
z
"}
(2,1,1) = {"
z
f
a
a
a
a
a
z
"}
(3,1,1) = {"
m
a
a
a
c
a
a
z
"}
(4,1,1) = {"
z
z
z
z
a
a
a
l
"}
(5,1,1) = {"
z
R
K
z
a
a
a
z
"}
(6,1,1) = {"
z
q
q
z
a
a
a
z
"}
(7,1,1) = {"
z
e
q
W
a
a
f
z
"}
(8,1,1) = {"
z
z
z
z
z
Y
z
z
"}

(1,1,2) = {"
N
C
C
C
C
C
C
N
"}
(2,1,2) = {"
j
b
V
V
V
r
D
j
"}
(3,1,2) = {"
j
o
V
V
p
C
V
V
"}
(4,1,2) = {"
j
X
J
O
d
C
V
j
"}
(5,1,2) = {"
j
C
C
C
C
C
V
j
"}
(6,1,2) = {"
V
V
V
V
V
V
V
j
"}
(7,1,2) = {"
j
s
P
B
H
B
u
j
"}
(8,1,2) = {"
N
C
C
C
C
C
C
N
"}
